a	ㄚ
a	ㄞ
a	ㄠ
a	ㄢ
a	ㄤ
aa	卬卬
aa	晻晻
aa	晻藹
aa	晻靄
aa	磑磑
aadb	嗷嗷待哺
aaxx	嗷嗷嘔嘔
aazz	挨挨桚桚
ab	凹版
ab	安泊
ab	拗彆
ab	案伯
ab	阿伯
abd	拗不登
abdc	安步當車
abdj	安步當車
abdy	阿鼻地獄
abg	拗不過
abh	凹版畫
abjc	拗彆攪炒
abkz	敖不可長
abys	凹版印刷
ac	安厝
ac	拗處
ac	挨呲
ac	昂藏
ac	暗藏
acc	暗沈沈
acxj	暗藏玄機
ad	凹地
ad	按調
ad	暗地
ad	暗澹
ad	阿獃
adkjbbd	安地卡及巴布達
adl	奧地利
adl	暗地裏
adlghg	奧地利共和國
adlsqd	安地列斯羣島
adly	安堵樂業
admds	哀的美敦書
ads	奧登塞
adssm	安地斯山脈
adw	安碓磑
afjf	挨風緝縫
afjf	捱風緝縫
afqf	挨風緝縫
afqf	捱風緝縫
afsb	阿伐蛻變
ag	阿家
aglsksr	盎格魯撒克遜人
agsd	奧古斯都
agsdsq	奧古斯都時期
agw	阿家翁
agzfd	愛國者飛彈
agzz	阿甘正傳
ah	拗花
ah	暗行
ah	阿吽
ah	隘害
ahbd	哀鴻遍地
ahdy	阿呼地獄
ahll	安和樂利
aj	拗句
aj	拗強
aj	阿姊
aj	隘窘
ajalbghg	埃及阿拉伯共和國
ajcb	挨肩擦膀
ajly	安家樂業
ajly	安居樂業
ajmq	暗箭明鎗
ak	拗口
ak	隘口
akf	拗口風
akl	拗口令
al	安樂
al	安陸
al	隘路
alb	阿拉伯
albbd	阿拉伯半島
albj	阿拉伯膠
albjs	阿拉伯膠樹
alblhdgg	阿拉伯聯合大公國
alblls	阿拉伯勞倫斯
alblm	阿拉伯聯盟
albr	阿拉伯人
albsm	阿拉伯沙漠
albsz	阿拉伯數字
alby	阿拉伯語
albz	腌裏巴臢
albzm	阿拉伯字母
alg	安樂國
algz	安樂公主
alr	阿蘭若
als	安樂死
alsj	安樂世界
alw	安樂窩
aly	安樂椅
am	奧祕
am	安謐
am	拗蠻
am	晻昧
am	闇莫
amj	凹面鏡
an	懊憹
an	欸乃
andl	阿耨多羅
anklnn	安娜·卡列尼娜
anq	欸乃曲
apdm	阿毗達磨
apld	安貧樂道
aplj	安貧樂賤
apt	阿毗曇
aql	安全率
aqt	阿伽陀
aqzr	按彊助弱
aqzz	拗曲作直
ar	佁然
as	媼神
as	安宿
as	晻世
as	阿誰
as	隘懾
asdt	暗射地圖
asl	奧斯陸
asl	阿闍梨
asly	安身樂業
asn	安闍那
ass	阿闍世
assh	挨山塞海
assm	卬首信眉
ast	奧斯汀
aszd	安身之地
at	凹凸
at	哀恫
at	哀慟
at	拗甜
at	拗體
atbp	凹凸不平
atj	凹透鏡
atly	安土樂業
ats	拗體詩
atyz	凹凸有致
atzq	安土重遷
ax	凹下
ax	凹陷
ax	媼相
ax	隘巷
ax	隘險
axggl	愛心刮刮樂
axjl	愛新覺羅
axy	凹心硯
axzz	安靜自在
ay	哎喲
ay	啊喲
ay	噯喲
ay	奧窔
ay	晻翳
aywj	愛遠惡近
ayy	噯喲喲
ayyy	安於一隅
ayzz	安營紮寨
az	俺咱
az	凹狀
az	卬燥
az	唵噆
az	安宅
azc	矮仔財
azzl	安宅正路
b	㑟
b	㓈
b	㓖
b	㓦
b	㔗
ba	泊岸
ba	狴犴
ba	褊隘
ba	邊隘
ba	鼻凹
bat	鼻凹糖
bb	不薄
bb	伯伯
bb	便便
bb	便祕
bb	八伯
bbcc	憋憋懆懆
bbcl	白不呲咧
bbd	薄薄的
bbdf	北部地方
bbdk	掤扒吊栲
bbdk	絣扒吊拷
bbdk	繃扒吊拷
bbdk	繃扒弔拷
bbj	刨冰機
bbjl	鞭辟近裏
bbl	比不了
bblfy	包伯利風衣
bbll	斑駁陸離
bbllx	便把令來行
bbm	𰻞𰻞麪
bbql	裨補闕漏
bbql	跛鱉千里
bbqq	薄薄怯怯
bbqy	不避彊禦
bbr	柏柏人
bbrl	鞭辟入裏
bbsy	拔本塞原
bbsy	拔本塞源
bbxw	步兵校尉
bbxx	步兵學校
bbxx	步步行兇
bby	不便宜
bbz	部部長
bbzd	不敗之地
bbzx	八步周行
bbzz	波波吒吒
bbzz	炳炳鑿鑿
bbzz	薄壁組織
bc	不曾
bc	不朝
bc	保藏
bc	冰藏
bc	包藏
bcbc	不偢不倸
bcbc	不瞅不睬
bcc	碧澄澄
bccz	補償財政
bcf	補償費
bchd	薄翅黃蝶
bchl	不差毫釐
bchx	包藏禍心
bchx	苞藏禍心
bcjxq	悲愴交響曲
bcjy	補償教育
bclj	半朝鑾駕
bcls	搬脣弄舌
bcmj	鞭長莫及
bcmy	不成模樣
bcny	北轍南轅
bcqy	薄脣輕言
bcs	白差使
bcsm	不差什麼
bcsm	蔽聰塞明
bct	保俶塔
bct	扳差頭
bctx	鞭笞天下
bcx	兵車行
bcx	北朝鮮
bcxc	報仇雪恥
bcxh	報仇雪恨
bczf	補償支付
bczh	筆參造化
bczm	不傳之祕
bczy	補償作用
bd	不的
bd	八都
bd	別調
bd	刨刀
bd	卜度
bdbql	棒打薄情郎
bdc	不對稱
bdct	拔地參天
bdd	不得地
bdd	不搭調
bde	八都兒
bde	巴都兒
bde	把都兒
bdeq	拔地而起
bdfg	本地風光
bdfx	編隊飛行
bdgddz	扒得高跌得重
bdh	本地化
bdh	本地貨
bdhh	遍地荒旱
bdhl	變動匯率
bdj	不對勁
bdj	不得勁
bdjhl	不當家豁拉
bdjl	本等伎倆
bdjx	倍道兼行
bdkh	遍地開花
bdl	不得了
bdl	伯多祿
bdl	八都魯
bdl	拔都魯
bdl	背地裏
bdlj	本地連接
bdq	不打慳
bdq	本地區
bdr	本地人
bdrj	八大人覺
bdss	班都斯山
bdt	擺地攤
bdw	本地網
bdw	標的物
bdwe	伯道無兒
bdx	寶坻縣
bdys	拔地搖山
bdyt	拔地倚天
bdz	不地着
bdz	布撣子
bdz	部隊長
bdzbs	邊都沾不上
bdzy	伯道之憂
be	不阿
be	伯恩
be	榜額
be	薄惡
be	辟惡
bedl	包爾德樂
bedm	巴爾的摩
befst	伯爾發斯特
beksh	巴爾喀什湖
best	伯恩斯坦
bexf	俾爾遐福
bf	伯封
bf	伯服
bf	伯父
bf	八幡
bf	哺坊
bfbs	不豐不殺
bfdq	部分地區
bfl	百分率
bfs	蚌埠市
bft	百沸湯
bfxw	不法行爲
bfxx	白費心血
bfys	撥風也似
bfyz	步飛煙傳
bfz	不犯着
bfz	百夫長
bfzc	不分主從
bfzy	暴風驟雨
bfzz	不分主從
bg	伯公
bg	伯格
bg	八垓
bg	半垓
bg	柏高
bgbg	不尷不尬
bgbj	不乾不淨
bgcbezcy	不貴尺璧而重寸陰
bgcz	補掛朝珠
bgd	白公堤
bgdd	辦公地點
bget	不顧而唾
bgg	不尷尬
bgh	報關行
bgj	不乾淨
bgjt	抱關擊柝
bgjw	伯歌季舞
bgks	不敢吭聲
bgm	柏格曼
bgmlz	白宮幕僚長
bgs	不更事
bgs	柏格森
bgsxsc	不管生癬生瘡
bgt	白公堤
bgtd	不共天地
bgxs	班功行賞
bgxs	稗官小說
bgxy	不乾性油
bgyj	波詭雲譎
bgys	稗官野史
bgz	脖頸子
bgzd	白圭之玷
bgzdbz	八竿子打不着
bgzlbz	八棍子撂不着
bh	㓦劃
bh	不還
bh	八行
bh	冰壑
bh	刨花
bhbj	白花八角
bhdwz	飽和單位重
bhf	白虎幡
bhht	薄海歡騰
bhj	薄荷精
bhn	薄荷腦
bhph	暴虎馮河
bhpp	秉笏披袍
bhqp	百卉千葩
bhry	飽和溶液
bhs	八行書
bhs	刨花水
bhs	鉋花水
bhsk	百花盛開
bhsy	渤海鎖鑰
bhsz	部會首長
bhtc	薄海同仇
bhxx	不護細行
bhy	薄荷油
bhyc	撥火又長
bhz	擺行陣
bhzc	白毫之賜
bhzh	捭闔縱橫
bhzs	白毫之賜
bhzw	跋胡疐尾
bhzz	跋扈自恣
bj	不給
bj	不覺
bj	伯姊
bj	伯姬
bj	伯爵
bjasf	伯吉阿斯法
bjc	抱角牀
bjd	濱豇豆
bjdd	斑鳩跌彈
bjdd	班鳩跌彈
bjdq	北京地區
bjdq	北極地區
bjdq	箔檢電器
bjdx	伯喈倒屣
bjex	並肩而行
bjfk	八角楓科
bjfl	擘肌分理
bjg	伯濟國
bjg	八角鼓
bjgd	苞苴竿牘
bjgj	不見圭角
bjgx	白駒過隙
bjgx	苞苴公行
bjhl	苞苴賄賂
bjhx	八角茴香
bjjp	八角金盤
bjjz	不見經傳
bjl	不唧𠺕
bjl	八角蓮
bjl	邊角料
bjlas	柏濟力阿斯
bjp	補給品
bjq	柏京其
bjq	白嚼蛆
bjq	百襉裙
bjqf	貝錦萋菲
bjr	白嚼人
bjs	不更事
bjss	辟君三舍
bjssb	柏金森氏病
bjsy	不龜手藥
bjte	補苴調胹
bjws	柏吉烏斯
bjx	不記省
bjx	簿記學
bjx	補給線
bjxfd	北極星飛彈
bjxl	補苴罅漏
bjxx	不拘細行
bjxx	不矜細行
bjy	不龜藥
bjy	白袷衣
bjyg	波譎雲詭
bjyh	北京銀行
bjyy	背景音樂
bjz	百將傳
bjz	補給站
bjz	補給證
bjzc	不解之仇
bk	伯克
bk	哺鷇
bk	奔潰
bk	崩潰
bk	擘開
bkcs	閉口藏舌
bkh	布喀河
bkjz	白口咀咒
bkl	不快樂
bkl	伯克來
bkl	柏克萊
bkl	柏卡里
bkmwdj	柏克曼溫度計
bkq	不吭氣
bks	別頦腮
bks	擘窠書
bkxj	別開蹊徑
bkygl	不可與共樂
bkzd	伯克制度
bkzf	不堪重負
bl	不了
bl	不樂
bl	不露
bl	伯力
bl	伯勞
blb	布綸堡
blbnsbd	伯羅奔尼撒半島
blbnstm	伯羅奔尼撒同盟
blbnszz	伯羅奔尼撒戰爭
blc	暴露出
blcj	不吝賜教
blcs	不老長生
blcs	暴厲恣睢
blcs	暴戾恣睢
bld	伯林頓
bld	保留地
bld	白蘭地
bldh	波羅的海
bldhsxg	波羅的海三小國
blds	扒拉大山
bldx	柏林大學
bldx	薄利多銷
blfc	博浪飛椎
blfm	不露鋒芒
blfs	不露風聲
blfx	擘兩分星
blfy	伯勞飛燕
blg	不樂觀
blg	伯慮國
blghg	祕魯共和國
blgj	不露圭角
blgz	跛羅蓋子
blh	不了漢
blh	伯利恆
blhy	柏林會議
blhy	灞陵呵夜
blhy	霸陵呵夜
blj	不了解
bljp	病理解剖
bljt	柏林劇團
bljz	跛立箕坐
bll	不了了
bll	白了了
bll	白泠泠
bllbdpk	拔了蘿蔔地皮寬
blld	不了了當
blll	蓽露藍蔞
bllz	不了了之
blmj	不露馬腳
bln	伯勞鳥
blnjz	柏利尼家族
blp	芭樂票
blpd	巴黎盆地
blq	不了情
blqd	百了千當
bls	勃露斯
bls	柏梁詩
blsj	不吝賜教
blss	不露神色
blss	不露聲色
blss	不露身手
blt	柏拉圖
blt	柏梁臺
blt	柏梁體
blt	檳榔攤
blt	白樂天
blwc	博覽五車
blwj	博覽五車
blwq	柏林圍牆
blx	博樂縣
blx	薄祿相
blxd	伯力協定
blxw	玻璃纖維
bly	檳榔嶼
bly	玻璃液
blyd	不留餘地
blyg	伯樂一顧
blyp	柏林樂派
blys	暴雷也似
blyz	柏林影展
blyz	貝類養殖
blzj	不了之局
blzq	暴戾之氣
blzs	暴厲恣睢
blzs	暴戾恣睢
bm	不瞑
bm	不繆
bm	伯母
bm	便祕
bm	弁冕
bmblf	薄膜剝離法
bmbz	不蔓不支
bmbz	不蔓不枝
bmcj	報名參加
bmcn	本末舛逆
bmcs	扁毛畜生
bmcydd	北美草原地帶
bmfxt	不明飛行體
bmh	伯明罕
bmh	伯明翰
bmhc	薄面含嗔
bmj	白眉鴃
bmm	不瞑目
bmn	薄命女
bmsc	閉明塞聰
bmsd	閉門塞竇
bmst	閉目塞聽
bmswxtwyh	北美事務協調委員會
bmsy	北門鎖鑰
bmy	柏木油
bmzc	閉門造車
bmzd	不毛之地
bmzg	抱蔓摘瓜
bmzj	閉門造車
bmzz	拔苗助長
bn	伯娘
bn	伯納
bn	便溺
bn	俾倪
bn	埤堄
bncf	百鳥朝鳳
bndk	被虐待狂
bnk	布那喀
bnm	不恁麼
bnmdx	巴拿馬地峽
bnwd	暴虐無道
bnzj	不能自給
bp	伯嚭
bp	伯婆
bp	報聘
bp	婢僕
bp	布疋
bplj	杯盤狼藉
bpwc	波旁王朝
bpx	北埔鄉
bpxj	別闢蹊徑
bpxq	薄批細切
bpy	不便宜
bpz	抱朴子
bpz	拔脯子
bpz	白蘋洲
bpz	薄片子
bpzz	薄片子嘴
bq	不愆
bq	伯強
bq	冰磧
bq	北圻
bq	婢妾
bqc	不氣長
bqdt	八旗都統
bqf	薄伽梵
bqg	柏青哥
bqh	冰磧湖
bqh	泊秦淮
bqhq	抱槧懷鉛
bqjs	兵強將盛
bql	薄情郎
bqlx	屏氣斂息
bqn	薄伽尼
bqns	屏氣凝神
bqq	不愜氣
bqq	薄伽丘
bqq	薄怯怯
bqs	拜稽首
bqsx	屏氣攝息
bqtzhq	貝伽特症候羣
bqwy	薄情無義
bqy	冰磧岩
bqysz	敗棋有勝着
bqzh	跋前疐後
bqzx	補氣止血
br	哺乳
br	報喏
br	榜人
br	般若
br	薄弱
brblmdxj	般若波羅蜜多心經
brbx	倍日并行
brbyss	不如薄藝隨身
brd	不入調
brd	巴人調
brdw	哺乳動物
brfs	髀肉復生
brgh	病入膏肓
brgh	病染膏肓
brhj	薄弱環節
brj	般若經
brk	百日咳
brl	哺乳類
brlg	不容樂觀
brm	不恁麼
brq	哺乳器
brs	不弱似
brt	般若湯
brxc	不染纖塵
bryhzy	不如一狐之腋
brz	白日撞
brzs	辟人之士
bs	不什
bs	不似
bs	不殺
bs	不熟
bs	伯叔
bsbl	不塞不流
bsbs	半生不熟
bsbs	半生半熟
bsc	半熟茶
bscj	百舍重繭
bscj	百舍重趼
bscx	杯水車薪
bsd	北上地
bsdh	本色當行
bsdh	被山帶河
bsdt	波斯地毯
bsdy	拔舌地獄
bse	巴塞爾
bsg	巴斯噶
bsgc	杯蛇鬼車
bsgd	拔山扛鼎
bsgj	杯蛇鬼車
bsgyy	巴士噶語言
bshc	班師回朝
bsj	不睡覺
bsje	巴什吉爾
bsjw	不溯既往
bsjx	杯水車薪
bskl	百事可樂
bsl	瓣鰓類
bslc	不是了處
bsll	不甚了了
bsll	伯舒拉嶺
bsln	巴塞羅那
bsln	巴塞隆納
bsm	俾斯麥
bsm	柏塞麥
bsm	白塞木
bsm	稗沙門
bsqs	拜手稽首
bsrd	白舌入地
bss	薄溼溼
bss	薄生生
bss	邊塞詩
bssd	八十四調
bssd	避暑勝地
bssm	不算什麼
bssw	百獸率舞
bssz	鼻塞聲重
bstzjmz	不是湯着就抹着
bswm	榜上無名
bsx	百色縣
bsxq	屏聲息氣
bsxx	不守細行
bsyj	冰山一角
bsz	白蛇傳
bsz	薄紹之
bszd	不食之地
bszd	畢生之玷
bszj	百乘之家
bszt	布什總統
bszy	變生肘腋
bt	不弟
bt	不忒
bt	不腆
bt	不調
bt	伯圖
btbl	半吐半露
btd	拜天地
btdq	不同地區
btey	不通痾癢
btf	不隄防
btg	白叨光
btpp	奔騰澎湃
btqs	暴殄輕生
bts	逋逃藪
btsb	貝他蛻變
btsjd	柏特斯加登
btt	不調貼
bttn	扒頭探腦
bttw	暴殄天物
btwf	柏臺烏府
btxd	冰天雪地
btxw	薄田朽屋
bty	不調勻
btyy	標題音樂
bw	旁午
bw	榜尾
bw	榜文
bw	泊位
bw	瀕危
bwgh	不忘溝壑
bwqj	博聞彊記
bwqjf	不完全給付
bwqy	不畏彊禦
bwqz	博聞強識
bwqz	博聞彊志
bwrh	波紋如縠
bww	柏文蔚
bwxg	薄物細故
bwyc	百無一長
bwzw	別無長物
bx	不屑
bx	不省
bx	不行
bx	不遜
bx	並行
bxb	白血病
bxbb	並行不悖
bxcx	不虛此行
bxd	不省得
bxdt	不賢都頭
bxdx	碧血丹心
bxfr	婢學夫人
bxgd	兵行詭道
bxh	伯希和
bxhh	碧血黃花
bxj	步行機
bxj	步行街
bxj	白行簡
bxjf	保險給付
bxjg	屏息靜觀
bxl	薄熙來
bxndz	敗血膿毒症
bxnq	屏息凝氣
bxns	屏息凝視
bxny	婢膝奴顏
bxny	稟性難移
bxpc	保險賠償
bxpd	不顯平地
bxq	白血球
bxqgdz	白血球過多症
bxqw	博學洽聞
bxr	薄倖人
bxrs	不省人事
bxs	不省事
bxs	便攜式
bxt	抱廈廳
bxwb	不修帷薄
bxws	不學亡術
bxx	柏鄉縣
bxxm	剝削小民
bxxq	褊狹小器
bxxt	畢宿星團
bxxw	博學洽聞
bxxx	補習學校
bxxxk	敗血性休克
bxxz	步線行針
bxyd	屏息以待
bxyg	不屑一顧
bxyq	撥弦樂器
bxz	剝削者
bxz	敗血症
bxzc	伯壎仲篪
bxzj	不學長俊
by	伯余
by	伯夷
by	伯彝
by	伯業
by	伯牙
bya	鼻咽癌
bycl	鼻偃齒露
byd	哺育袋
byd	炮羊肚
byd	鼻咽道
byds	弊衣簞食
byf	伯夷父
bygq	伯牙鼓琴
byjx	伯牙絕絃
byk	伯邑考
bykls	巴顏喀喇山
byl	柏油路
bylh	不亦樂乎
bylx	畢業旅行
bynzht	別要惱着火頭
byqz	伯俞泣杖
bysq	伯夷叔齊
bysx	便宜施行
bysx	補垣塞穴
byt	伯遠帖
bytd	別有天地
byxs	便宜行事
byy	鼻咽癌
byz	柏油紙
byz	白猿傳
byzj	不用着急
byzx	不虞之隙
byzy	伯雍種玉
bz	不着
bz	不賺
bz	不重
bz	並重
bz	伯仲
bzbd	百戰不殆
bzbj	不着邊際
bzbj	不知不覺
bzbl	不着不落
bzbx	不止不行
bzc	柏舟操
bzd	不着調
bzdc	拔着短籌
bzdd	不支倒地
bzdh	波磔點畫
bzdmyp	八字都沒一撇
bzdz	不在地主
bzek	不戰而潰
bzfr	婢作夫人
bzgh	病在膏肓
bzh	不在行
bzhj	不着痕跡
bzhm	薄祚寒門
bzj	不着家
bzj	不着急
bzj	不着腳
bzj	不知覺
bzj	不自覺
bzjf	不杖期夫
bzjj	不着筋節
bzjq	避重就輕
bzjr	不着家人
bzl	不着陸
bzlfx	不着陸飛行
bzm	不着忙
bzm	伯祖母
bzny	北轍南轅
bzq	不着情
bzq	不着親
bzq	鈀子拳
bzqz	不知輕重
bzqz	不足輕重
bzr	不着人
bzs	伯趙氏
bzsj	伯仲叔季
bztgdh	不知天高地厚
bztgdx	不知天高地下
bztl	捕捉畋獵
bztr	不着疼熱
bzty	不着痛癢
bzwx	彼長我消
bzwxz	不在五行中
bzx	卜窀穸
bzx	百濯香
bzxr	被執行人
bzy	不着意
bzy	不着要
bzy	伯子牙
bzyc	撥着癢處
bzyg	幣重言甘
bzyj	不長眼睛
bzyz	不着一字
bzyz	不長一智
bzz	不終朝
bzzd	必爭之地
bzzj	伯仲之間
bzzj	柏舟之節
bzzs	柏舟之誓
bzzs	變徵之聲
bzzt	柏舟之痛
bzzy	俾晝作夜
bzzy	變徵之音
c	ㄔ
c	ㄘ
c	㐜
c	㐸
c	㐼
ca	長安
ca	長案
cads	長安道上
caft	長安福特
caj	長安街
cajdby	長安居大不易
cary	長安如弈
cb	側柏
cb	儕輩
cb	償補
cb	出榜
cb	刺柏
cbbgycd	重編本國語辭典
cbc	糙不糙
cbcmj	差半車麥秸
cbd	瞅不得
cbfx	出版發行
cbj	瞅不見
cbj	蔡伯喈
cbkj	成本會計
cbl	出不了
cbl	喫不了
cbl	成不了
cbl	錯不了
cbldzz	喫不了兜着走
cbm	長鼻目
cbnx	寸步難行
cbp	長坂坡
cbq	瞅不起
cbs	長白山
cbsl	垂白上僂
cbw	重瓣胃
cbwh	長濱文化
cbwkgx	楚霸王困垓下
cbx	長臂蝦
cby	翅膀硬
cby	長臂猿
cbyh	儲備銀行
cbz	猜不着
cbz	陳伯之
cbzq	沈不住氣
cc	倅車
cc	倉卒
cc	偢采
cc	儲藏
cc	出差
ccbq	參差不齊
ccbz	采椽不斲
ccc	長攙攙
cccd	寸長尺短
cccj	寸長尺技
cccl	參差錯落
ccd	長長的
ccdd	藏藏躲躲
ccdd	重重疊疊
ccdd	長長短短
ccdx	層出疊見
ccf	出差費
ccfpwll	乘長風破萬里浪
ccg	程長庚
cch	長春花
ccjh	重出江湖
ccjy	從長計議
ccjy	重操舊業
cclj	出醜狼藉
cclj	錯彩鏤金
ccll	重重落落
ccls	草草了事
ccmj	車轍馬跡
ccml	晨參暮禮
ccmx	晨參暮省
ccnn	搐搐搦搦
ccs	長春市
cct	長處搯
ccww	顫顫巍巍
ccyw	長此以往
ccyy	扯扯拽拽
ccz	處處長
cczd	尺寸之地
cczh	裳裳者華
cd	仇敵
cd	剗地
cd	卒倒
cd	參度
cd	參訂
cdby	長短不一
cdc	出大差
cdcc	尺短寸長
cdcl	沈澱出來
cdct	寸地尺天
cdd	沈甸甸
cdd	顫抖抖
cdf	沈澱法
cdfc	重蹈覆轍
cdfs	鴟得腐鼠
cdfz	重蹈覆轍
cdg	曹大家
cdgl	差動滑輪
cdgq	褫奪公權
cdh	磣的慌
cdht	愴地呼天
cdj	長短句
cdjf	鐺底焦飯
cdjg	產地價格
cdjx	唱獨角戲
cdjy	慘澹經營
cdjz	澄澹精致
cdl	剎帝利
cdl	喫得了
cdl	次大陸
cdm	喫地面
cdmb	成都賣卜
cdmd	財多命殆
cdmf	車殆馬煩
cdmpd	柴達木盆地
cdp	炒地皮
cdpy	成都平原
cdql	赤地千里
cdr	成都人
cds	成都市
cdsc	臭短臊長
cdsy	償得夙願
cdsz	財多勢重
cdtr	重睹天日
cdw	沈澱物
cdwxzs	匙大碗小之事
cdwysbl	此地無銀三百兩
cdx	昌都縣
cdx	重定向
cdyl	嘗鼎一臠
cdzms	醋打怎麼酸
cdzq	沈得住氣
cdzx	惻怛之心
ce	俶爾
ce	崇阿
ce	沈痾
ce	沉痾
ce	舛訛
cebq	長惡不悛
ceg	長耳公
cex	長耳鴞
cf	傖父
cf	償付
cf	孱夫
cf	差法
cf	差發
cfb	長鋒筆
cfd	唱反調
cfjq	藏風聚氣
cfjs	重復建設
cfks	重複課稅
cfle	藏鋒斂鍔
cflm	重赴鹿鳴
cfls	餐風露宿
cfmn	腸肥腦滿
cfpl	長風破浪
cfqh	慚鳧企鶴
cfsl	餐風宿露
cfsr	傖夫俗人
cfss	餐風宿水
cfsy	餐風宿雨
cft	長方體
cftz	搓粉摶朱
cfwl	長風萬里
cfx	重複性
cfx	長方形
cfxl	餐風吸露
cfxt	陳蕃下榻
cfxz	摧鋒陷陣
cfxz	衝鋒陷陣
cfyl	春風雨露
cfyl	餐風飲露
cfys	陳蕃一室
cfzj	轍鮒之急
cg	傳柑
cg	刺柑
cg	參股
cg	參觀
cg	參革
cgc	出公差
cgc	喫乾醋
cgcj	懲羹吹齏
cgd	仇疙瘩
cgd	唱高調
cgd	草紇繨
cgdj	重規疊矩
cgdk	長歌當哭
cgdq	撦鼓奪旗
cgdx	長庚大學
cggd	朝歌鼓刀
cghc	藏垢懷恥
cghf	拆骨還父
cgj	超感覺
cgl	仇國論
cgl	成功率
cglc	出乖露醜
cglj	重規累矩
cglk	蓴羹鱸膾
cglq	重光累洽
cglx	春光漏泄
cglx	重光累洽
cglz	曹劌論戰
cgmtx	長梗滿天星
cgnw	藏垢納污
cgpp	采光剖璞
cgq	踩高蹻
cgq	長干曲
cgx	長干巷
cgxh	才高行厚
cgxj	才高行潔
cgxj	重規襲矩
cgz	參觀者
cgz	插扛子
ch	仇恨
ch	儃佪
ch	償還
ch	出笏
ch	參劾
chc	出紅差
chdd	春回大地
chds	攙行奪市
chds	長話短說
chdx	晨昏定省
che	尺蠖蛾
chg	赤鯶公
chg	重華宮
chg	長恨歌
chhy	瞠乎後矣
chj	充行家
chjx	厝火積薪
chk	出火炕
chk	插火坑
chl	存活率
chl	成活率
chmf	搽灰抹粉
chmt	搽灰抹土
chqh	瞠乎其後
cht	參話頭
cht	掣後腿
chtx	轍環天下
chw	重環紋
chwl	喫喝玩樂
chwt	朝核問題
chz	長恨傳
chzl	穿紅着綠
chzq	尺蠖之屈
cj	丑角
cj	串疽
cj	仇家
cj	倅車
cj	儕居
cjb	擦肩膀
cjba	踧踖不安
cjc	塵芥蟲
cjc	酢漿草
cjch	曾經滄海
cjchnws	曾經滄海難爲水
cjd	曾經的
cjd	穿甲彈
cjd	長豇豆
cjdg	重九登高
cjdl	長江電力
cjdq	長江大橋
cjf	長腳蜂
cjfc	重見複出
cjfr	成績斐然
cjfy	叱嗟風雲
cjg	長角果
cjgg	處境尷尬
cjgk	參加高考
cjgz	參加工作
cjhd	參加活動
cjhlcql	長江後浪催前浪
cjhs	曾幾何時
cjhy	參加會議
cjjjt	長焦距鏡頭
cjjy	操奇計贏
cjl	叉角羚
cjl	長距離
cjl	長頸鹿
cjlh	釵腳漏痕
cjlwxdh	長距離無線電話
cjly	長江流域
cjlz	掣襟露肘
cjnh	長頸鳥喙
cjpq	插金披綺
cjq	藏精器
cjs	沈積石
cjsg	曾經說過
cjsjz	長江三角洲
cjsx	長江三峽
cjt	長鏡頭
cjtq	長江天塹
cjtr	重見天日
cjtx	乘間投隙
cjwgf	喫幾碗乾飯
cjwly	長江無六月
cjwz	插架萬軸
cjx	澂江縣
cjxl	沈靜下來
cjxz	摧堅陷陣
cjxz	衝堅陷陣
cjy	沈積岩
cjyy	曾經擁有
cjz	參加者
cjzj	長久之計
cjzlh	喫角子老虎
cjzq	長江證券
cjzx	掣襟肘見
ck	參看
ck	參考
ck	喘咳
ck	孱困
ck	朝考
ckbs	赤口白舌
ckdh	插科打諢
ckjg	參考價格
ckjszpy	喫虧就是占便宜
ckk	磣可可
ckk	磣磕磕
ckl	赤嵌樓
cklc	財匱力絀
ckld	脆快了當
ckll	存款利率
ckll	拆款利率
cklz	刺客列傳
cks	參考書
cksq	插科使砌
ckwd	慚愧無地
ckwx	參考文獻
ckzbl	存款準備率
ckzl	參考資料
cl	儕倫
cl	參靈
cl	呈露
cl	垂綸
cl	垂露
clbe	柴立不阿
clc	粗肋草
cld	催淚彈
clez	觸類而長
clf	差旅費
clfc	長林豐草
clfm	初露鋒芒
clg	長樂宮
cll	卒律律
clm	重羅麪
clpw	喫裏扒外
clqm	轍亂旗靡
clqs	春露秋霜
clsl	豺狼塞路
cltj	初露頭角
cltx	崔烈銅臭
clw	拆爛污
clwh	藏龍臥虎
clwy	長樂未央
clx	屯留縣
clzm	車笠之盟
clzs	采蘭贈芍
cm	乘馬
cm	償命
cm	出沒
cm	參謀
cm	存沒
cmb	草帽緶
cmbd	出沒不定
cmbs	長命百歲
cmbx	沈迷不醒
cmby	沈默不語
cmcb	攢眉蹙鼻
cmct	蹙眉長歎
cmd	長命釘
cmd	長明燈
cmes	瞠目而視
cmf	長門賦
cmfg	長命富貴
cmfx	草靡風行
cmgj	聰明乖覺
cmgy	沈默寡言
cmhw	鴟目虎吻
cmjs	瞠目結舌
cmjt	重門擊柝
cmkl	攢眉苦臉
cml	長命縷
cmlwh	春夢了無痕
cmly	草滿囹圄
cmm	重命名
cmml	疵蒙謬累
cmpt	車馬駢闐
cmr	長毛絨
cms	長命鎖
cmsf	蟲鳴水沸
cmss	重門深鎖
cmtx	觸目慟心
cmwc	出沒無常
cmwl	魑魅魍魎
cmx	澄邁縣
cmx	草木樨
cmx	長毛象
cmz	參謀長
cmzz	臭名昭著
cn	傖儜
cn	剎那
cn	從女
cn	慚恧
cn	搐搦
cnc	長年菜
cnd	處女地
cnh	充內行
cnj	剎那間
cnl	腸粘連
cnly	長年累月
cnq	長寧區
cny	澄泥硯
co	攢毆
cp	參破
cp	參評
cp	坼副
cp	垂披
cp	差品
cpbq	此仆彼起
cpdl	長篇大論
cpj	磁偏角
cpkl	長篇闊論
cpld	長篇累牘
cplz	長篇連載
cpx	春丕峽
cpxs	長篇小說
cpyy	長轡遠御
cpyy	長轡遠馭
cpzz	長平之戰
cq	儭錢
cq	充詘
cq	出糗
cq	勦竊
cq	參請
cqb	春秋榜
cqbl	騁強背理
cqbx	春秋筆削
cqdb	才輕德薄
cqdb	材輕德薄
cqds	春秋鼎盛
cqds	藏器待時
cqer	長驅而入
cqfl	春秋繁露
cqfp	長期飯票
cqh	澄清湖
cqh	重啓後
cqj	磁傾角
cqj	長慶集
cqjr	長驅徑入
cql	藏起來
cqld	陳腔濫調
cqlh	參前落後
cqmz	擦拳抹掌
cqqs	長期趨勢
cqral	財去人安樂
cqs	重慶市
cqs	長崎市
cqs	長青樹
cqsal	財去身安樂
cqsb	朝遷市變
cqsy	長期使用
cqsz	春秋三傳
cqt	長慶體
cqtx	澄清天下
cqtz	長期投資
cqx	長期性
cqxd	採取行動
cqxy	長青學苑
cqyl	長期以來
cqzr	長驅直入
cqzsz	春秋左氏傳
cr	仇人
cr	俶擾
cr	卒然
cr	呫嚅
cr	唱喏
crbl	慘然不樂
crcd	持人長短
crcs	愴然垂首
crhl	差若豪釐
crjqmrg	車如雞棲馬如狗
crmz	脣若抹硃
crrs	悵然若失
crtd	出人頭地
crxj	仇人相見
crzs	悵然自失
crzzw	長日照植物
cs	仇殺
cs	仇視
cs	傖俗
cs	催熟
cs	充塞
csbl	盛水不漏
csbl	長生不老
csbm	長生不滅
csbs	長生不死
csbx	沈睡不醒
csbz	村生泊長
csc	沈砂池
csd	出生地
csd	成熟度
csd	种師道
csd	長生殿
csdb	才疏德薄
csdb	餐松啖柏
csds	重三疊四
csdtt	搓熟的湯團
csdz	春盛擔子
csf	長舌婦
csfm	重生父母
csfs	蔡順分椹
csg	長生果
cshz	長沙會戰
csj	長三角
csj	長時間
csjh	摧山攪海
csjh	重拾舊歡
csjl	澄思寂慮
csjs	草率將事
csjs	長生久視
csjw	攢三聚五
csk	長生庫
csl	出生率
csl	褚遂良
cslb	炊沙鏤冰
cslt	赤身露體
cslw	長生祿位
csm	出什麼
csm	喫什麼
csm	穿什麼
csm	長壽麪
csmz	脣似抹硃
csn	重孫女
csnnz	草是年年長
csp	藏書票
cspc	寸善片長
cspw	長生牌位
csq	成熟期
csq	長歲錢
csqj	廁身其間
css	藏室史
css	褚少孫
css	長沙市
cssb	草率收兵
cssb	餐松食柏
cssh	春深似海
cssl	傳輸速率
cssl	春盛食罍
cst	長舌頭
cstb	輟食吐哺
cswd	陳寔遺盜
cswj	恣睢無忌
csws	沈思往事
csx	常熟縣
csx	重侍下
csx	重孫媳
csxj	長繩繫景
csxr	長繩繫日
csxs	參賽選手
csxx	春誦夏絃
csyl	長算遠略
csyn	重生爺娘
csz	參賽者
csz	种師中
csz	草實枳
csz	車桑仔
cszb	乘勝逐北
cszz	垂死掙扎
ct	參堂
ct	參天
ct	參譚
ct	參透
ct	參頭
ctb	長頭布
ctbkyrwj	朝廷不可一日無君
ctbl	醜態畢露
ctbrdt	長痛不如短痛
ctbs	長途跋涉
ctc	搊彈詞
ctcd	寸土尺地
ctd	闖天地
ctdh	長途電話
ctdl	朝天搗亂
ctdr	長天大日
ctdt	長亭短亭
ctdxd	陳摶的兄弟
ctf	長頭髮
ctg	朝天宮
cth	孱頭貨
cthd	愴天呼地
cthd	朝天餛飩
ctht	朝天餛飩
ctj	朝天髻
ctj	槭糖漿
ctkn	藏頭亢腦
ctl	村天樂
ctl	草頭露
ctlj	出頭露角
ctlm	出頭露面
ctlr	長天老日
ctlw	藏頭露尾
ctly	藏頭漏影
ctnlx	刺頭泥裏陷
ctq	參同契
ctqx	草薙禽獮
ctt	長條圖
ctw	長統襪
ctxl	重貼現率
ctzd	撐天柱地
cw	䫄外
cw	偢問
cw	厜㕒
cw	參伍
cw	參悟
cwfb	慈烏反哺
cwfb	慈烏返哺
cwg	褚威格
cwh	長尾猴
cwhd	拆屋還地
cwj	長尾雞
cwj	長尾鮫
cwjm	重溫舊夢
cwjy	重溫舊業
cwkzn	長尾闊嘴鳥
cwng	藏污納垢
cww	顫巍巍
cwxt	臭味相投
cwxz	乘僞行詐
cwy	長吻魚
cwzt	汆丸子湯
cx	串行
cx	乘隙
cx	仇隙
cx	仇香
cx	傳檄
cxaz	重新安裝
cxbd	朝鮮半島
cxcs	騁兇騁勢
cxct	促膝長談
cxd	從兄弟
cxdc	層見疊出
cxdt	長吁短嘆
cxdx	赤血丹心
cxed	傳檄而定
cxer	乘隙而入
cxf	長休飯
cxfyy	長線放遠鷂
cxfzdyjgp	醜媳婦總得要見公婆
cxg	長休告
cxg	長信宮
cxhd	重新回到
cxhx	朝鮮海峽
cxj	朝鮮薊
cxjh	重修舊好
cxjh	重現江湖
cxjz	長效機制
cxkq	摧陷廓清
cxks	重新開始
cxky	稱心快意
cxlq	重熙累洽
cxls	草行露宿
cxlx	重熙累洽
cxmy	稱心滿意
cxmz	稱心滿志
cxny	藏形匿影
cxpg	摧心剖肝
cxqd	重新啓動
cxqs	垂馨千祀
cxrs	重新認識
cxry	稱心如意
cxs	長相思
cxs	陳省身
cxsc	垂涎三尺
cxss	長相廝守
cxsw	長袖善舞
cxtz	出血筒子
cxtz	澄心堂紙
cxw	朝鮮文
cxwz	暢行無阻
cxx	喘吁吁
cxy	朝鮮語
cxy	赤血鹽
cxyc	饞涎欲垂
cxyd	垂涎欲滴
cxyd	饞涎欲滴
cxyh	儲蓄銀行
cxyh	厝薪於火
cxyq	擦弦樂器
cxyx	程序運行
cxz	朝鮮族
cxzf	抽薪止沸
cxzr	重新做人
cxzz	持續增長
cxzz	朝鮮戰爭
cxzz	遲行早住
cy	仇怨
cy	倘佯
cy	償願
cy	參演
cy	參與
cyb	讖語餅
cybx	出言不遜
cyd	策源地
cydc	抽樣調查
cydr	重裀疊褥
cydz	重巖疊嶂
cyfx	草偃風行
cyh	參議會
cyh	朝陽花
cyhl	差以毫釐
cyhl	差以豪釐
cyj	重陽節
cyjb	懲一戒百
cyjb	懲一警百
cyjd	產業基地
cyjx	蒼蠅見血
cykjdx	朝陽科技大學
cylc	吹影鏤塵
cyld	重裀列鼎
cyly	沈魚落雁
cylz	呲牙裂嘴
cylz	雌牙露嘴
cym	重陽木
cymh	長役夢魂
cyq	吹樂器
cyq	朝陽區
cyr	重陽日
cys	糙葉樹
cysc	寸有所長
cysz	出芽生殖
cywd	措顏無地
cyx	朝陽縣
cyy	參議員
cyy	參議院
cyy	長夜飲
cyy	顫悠悠
cyz	參與者
cyz	搓圓仔
cyzb	澄源正本
cyzm	澶淵之盟
cyzt	搓圓仔湯
cyzxc	槭葉止血草
cz	乘傳
cz	俶裝
cz	側重
cz	傳著
cz	傳重
czb	楮知白
czbe	持正不阿
czbj	喫着不盡
czbz	財政部長
czc	車軸草
czcm	重足側目
czcx	崇正黜邪
czd	側重點
czdb	穿着打扮
czdb	長枕大被
czel	重足而立
czf	藏針縫
czff	重作馮婦
czfhxt	側撞防護系統
czfy	叱吒風雲
czg	成長股
czgc	成長過程
czgy	沉重寡言
czhl	差之毫釐
czja	長治久安
czjb	長足進步
czjg	重置價格
czk	仇者快
czl	成長率
czl	長着臉
czly	長嘴獠牙
czmd	次殖民地
czmf	搽脂抹粉
czmf	擦脂抹粉
czmj	車轍馬跡
czms	藏之名山
czms	藏諸名山
czmtjzh	曾着賣糖君子哄
czng	藏舟難固
czq	參政權
czq	承重牆
czq	沈住氣
czqg	重振旗鼓
czqg	重整旗鼓
czqy	參展企業
czr	重整人
czs	參展商
czs	承重孫
czs	腸阻塞
czsy	沉重少言
cztk	沉着痛快
czwx	從中斡旋
czx	成長性
czx	沈滯性
czxf	重振雄風
czxf	長齋繡佛
czxt	重裝系統
czy	次重音
czyf	草長鶯飛
czym	黜陟幽明
czyq	吹奏樂器
czyrhzg	朝中有人好做官
czyz	參政議政
czyz	沉着應戰
czzf	衝州撞府
czzs	參知政事
czzs	牀笫之私
d	㐤
d	㐲
d	㑈
d	㑙
d	㒔
da	低凹
da	堤岸
da	點拗
dadlsqd	大安地列斯羣島
daj	鄧艾吃
das	堤岸市
daxz	東挨西撞
db	單薄
db	嘚啵
db	地保
db	地板
db	地標
dbc	地板操
dbcd	調撥車道
dbcs	得不償失
dbcs	德薄才疏
dbcy	端本澄源
dbdq	東北地區
dbdq	東部地區
dbdz	斗杓東指
dbe	打悲阿
dbg	打飽咯
dbgt	對簿公堂
dbgy	澹泊寡欲
dbj	東北角
dbk	犢鼻褌
dbl	到不了
dbl	動不了
dbl	大不了
dbl	待不了
dbl	東柏林
dblw	砥兵礪伍
dbml	淡泊名利
dbmz	澹泊明志
dbnpj	大般涅槃經
dbnx	德薄能鮮
dbp	地不怕
dbq	碇泊區
dbqj	調兵遣將
dbrc	大筆如椽
dbrn	大辯若訥
dbs	都把勢
dbsc	地崩山摧
dbsjx	等邊三角形
dbww	淡薄無味
dbx	調百戲
dbxz	大擺褶子
dbxz	東奔西撞
dbyd	地板運動
dbyz	都鄙有章
dbz	地不載
dbz	大伯子
dbz	弔膀子
dbz	點不着
dbzs	斗杓轉勢
dc	丁差
dc	丹墀
dc	代償
dc	倒裳
dc	典藏
dcb	典藏本
dcb	調查表
dcbd	斷長補短
dcbg	調查報告
dcc	打喳喳
dcc	調車場
dcch	斷釵重合
dcd	當差的
dcdj	大喫大嚼
dcdq	地醜德齊
dcdx	代拆代行
dcfc	電掣風馳
dcg	地產股
dcgj	多重國籍
dcgz	調查工作
dchw	多藏厚亡
dcj	大長今
dcjg	調查結果
dckldx	大蟲口裏倒涎
dclp	獃串了皮
dclx	單車旅行
dcp	打攢盤
dcp	釘齒耙
dcq	調查權
dcqz	調查取證
dcrg	多重人格
dcrz	大長日子
dcs	地產商
dcsg	多財善賈
dcsj	多長時間
dcsl	倒裳索領
dcsy	得償所願
dctb	地坼天崩
dcte	倒持泰阿
dcts	頂橦踏索
dcwj	調查問卷
dcx	大出血
dcx	滇池縣
dcxc	電掣星馳
dcxd	度長絜大
dcxd	斷長續短
dcxd	東藏西躲
dcxg	多重性格
dcxs	調查顯示
dcxx	地層下陷
dcxz	東穿西撞
dcy	大單于
dcy	調查員
dcy	豆豉油
dcyj	調查研究
dcz	調查組
dcze	獨喫自痾
dczs	短長之說
dczx	當朝宰相
dczy	大處着眼
dd	低地
dd	低調
dd	倒地
dd	儋石
dd	兜底
ddc	調度場
ddcc	躲躲藏藏
ddcs	大地重生
ddd	呆呆地
ddd	獃獃的
dddd	地地道道
dddd	彈道導彈
dddd	道道地地
dddx	掇東掇西
dddx	獨斷獨行
ddex	顛倒而行
ddfd	彈道飛彈
ddg	低地國
ddgy	大纛高牙
ddh	呆打頦
ddh	大都會
ddh	大都護
ddhc	大地回春
ddhgjy	大都會歌劇院
ddhl	倒地葫蘆
ddhq	大都會區
ddhx	韃靼海峽
ddj	對對角
ddjt	動地驚天
ddjx	刀刀見血
ddjy	澹淡經營
ddkkh	的的喀喀湖
ddl	大都來
ddll	度德量力
ddmg	鈍刀慢剮
ddmm	丟丟抹抹
ddmm	都都摸摸
ddmm	都都磨磨
ddmz	打都磨子
ddp	打地鋪
ddpf	單調平凡
ddpp	喋喋便便
ddpp	攧攧仆仆
ddqk	顛倒乾坤
ddql	地丁錢糧
ddql	跌宕遒麗
ddqq	的的確確
ddr	當地人
ddrtdx	大毒日頭地下
dds	到底誰
dds	大都市
dds	打哆嗦
dds	調度室
ddsj	當地時間
ddsm	得到什麼
ddss	到底是誰
ddsy	地動山搖
ddt	打倒褪
ddwb	地大物博
ddwf	地大物豐
ddwxkzpz	碟大碗小磕着碰着
ddx	的篤戲
ddxc	東躲西藏
ddxm	定鼎訏謨
ddxw	單獨行爲
ddxz	打點行裝
ddy	地動儀
ddyc	顛倒衣裳
ddyf	大啖一番
ddyp	倒打一耙
ddz	大地主
ddz	大地震
ddz	大隊長
ddz	店都知
ddz	打彈子
ddzf	當地政府
ddzx	儋石之畜
ddzx	獨斷專行
ddzz	跌跌撞撞
de	地兒
de	棣鄂
de	躉兒
df	地分
df	地府
df	地方
df	堤封
df	堤防
dfbj	鼎沸不絕
dfcc	典範長存
dfcc	帶俸差操
dfcz	地方財政
dfcz	道範長昭
dfddq	東非大地塹
dffq	地方分權
dffy	地方法院
dfg	地方官
dfg	大腹賈
dfg	豆腐乾
dfgp	地府勾牌
dfhj	地方火甲
dfj	東方騎
dfjj	地方經濟
dfmp	顛番面皮
dfpp	大腹便便
dfrq	地方人情
dfrs	地方人士
dfs	地方上
dfs	地方時
dfs	地方稅
dfsc	地方色彩
dftd	當坊土地
dftf	地覆天翻
dfts	地方特色
dfx	地方性
dfx	地方戲
dfxq	地方戲曲
dfxtz	都付笑談中
dfxw	地方新聞
dfxx	帶髮修行
dfyh	地方議會
dfz	地方志
dfzf	地方政府
dfzz	地方自治
dfzz	大幅增長
dfzz	掇蜂譖子
dg	地宮
dg	地棍
dg	地溝
dg	地瓜
dg	大古
dgb	點鬼簿
dgbdz	登高必跌重
dgdd	動感地帶
dgdwp	但管地無皮
dgdx	帝國大廈
dgg	頂括括
dgh	大括弧
dghn	刀耕火耨
dgl	大剛來
dgl	大功率
dgl	戴高樂
dgl	電功率
dglc	大古裏彩
dgls	雕肝鏤腎
dgp	搭乾鋪
dgq	地瓜簽
dgq	點鋼鍬
dgqz	東瓜茄子
dgrc	地廣人稠
dgrx	地廣人稀
dgs	東莞市
dgwz	德高望重
dgx	東莞縣
dgxdxt	等高線地形圖
dgy	打乾噦
dgz	大剛喒
dgz	打工仔
dgz	獃根子
dgzz	刀割針扎
dh	丹雘
dh	佃戶
dh	低徊
dh	地戶
dh	地滑
dhb	登虎榜
dhb	電話簿
dhby	低徊不已
dhbz	打虎不着
dhc	大回朝
dhck	打諢插科
dhcs	當行出色
dhd	獃憨獃
dhfk	打諢發科
dhfx	彈痕分析
dhg	大會垓
dhg	打頦歌
dhgf	單鵠寡鳧
dhgs	倒笏躬身
dhh	打和哄
dhhdqxd	打虎還得親兄弟
dhj	當行家
dhl	兌換率
dhl	德黑蘭
dhlg	雕蚶鏤蛤
dhlhy	德黑蘭會議
dhls	調虎離山
dhms	電話祕書
dhn	地黃牛
dhq	打呵欠
dhq	都會區
dhs	打齁睡
dhs	調喉嗓
dhsx	打諢說笑
dhwx	都會文學
dhx	大換血
dhxf	斷鶴續鳧
dhy	大行院
dj	乣軍
dj	侗劇
dj	倒嚼
dj	兜剿
dj	動勁
djbb	咄嗟便辦
djbs	短見薄識
djcg	疊矩重規
djcxjd	東家長西家短
djcz	待價藏珠
djd	多角度
djdfchz	大角度俯衝轟炸
djeb	咄嗟而辦
djfg	砥節奉公
djgg	地價公告
djh	多角化
djh	豆秸灰
djjy	多角經營
djkb	咄嗟可辦
djl	大家樂
djl	打擊率
djl	點擊率
djlg	打淨撈乾
djlx	砥節礪行
djml	掂斤抹兩
djql	地盡其利
djqw	殫見洽聞
djrx	地瘠人稀
djs	地價稅
djs	地檢署
djs	地級市
djsd	度假勝地
djsg	砥節守公
djsjx	等角三角形
djsl	遯跡山林
djss	獨角赦書
djsxjs	東家食西家宿
djsz	大奸似忠
djsz	大姦似忠
djt	地籍圖
djt	大姊頭
djtc	地久天長
djty	地角天涯
djx	多角形
djx	大覺醒
djx	對角線
djx	獨角戲
djx	等角線
djxw	殫見洽聞
djxyh	單腳鞋銀行
djxz	膽驚心顫
djy	打擊樂
djy	都江堰
djyj	彈盡援絕
djyq	打擊樂器
djys	都江堰市
djyy	斗絕一隅
djz	大家長
djzzf	度君子之腹
dk	地塊
dk	地殼
dk	地炕
dk	彈坑
dk	彈殼
dkbb	吊拷絣把
dkbb	吊拷繃扒
dkbb	弔拷繃扒
dkbd	地殼變動
dkd	打窠地
dke	達喀爾
dkh	大括弧
dkk	獃磕磕
dkl	搭克露
dkll	貸款利率
dkms	頓開茅塞
dkstx	刀口上舔血
dktc	敵愾同仇
dl	丁泠
dl	刀螂
dl	單醪
dl	單露
dl	地利
dlb	大老闆
dlbc	大陸冰川
dlbh	大陸冰河
dlbk	大陸板塊
dlbkx	歹路不可行
dlbl	的黎波里
dlbrrh	地利不如人和
dlby	大陸邊緣
dlc	登陸場
dlcb	斷爛朝報
dlddbj	跌了彈的斑鳩
dldl	的留的立
dldq	大陸地區
dlds	哆囉哆嗦
dlfj	砥礪風節
dlfx	大陸法系
dlg	地理鬼
dlg	地裏鬼
dlg	大陸國
dlgl	的溜骨碌
dlh	大陸海
dlh	大陸貨
dlhj	地理環境
dlhy	大陸會議
dlhy	電力行業
dlj	大陸架
dlj	都料匠
dljc	大陸礁層
dljcgy	大陸礁層公約
dljg	地理景觀
dljs	地理腳色
dlk	大陸客
dll	低利率
dll	地靈靈
dll	的溜溜
dllb	多氯聯苯
dlld	噹啷落地
dlld	大陸隆堆
dllg	大陸勞工
dllq	大陸隆起
dllqt	大陸冷氣團
dlly	砥礪廉隅
dlm	大陸妹
dlm	大陸棉
dlmh	砥礪名號
dlmj	砥礪名節
dlmx	砥礪名行
dlp	大陸坡
dlp	大陸棚
dlp	大陸片
dlpl	的溜撲碌
dlpys	大陸漂移說
dlq	登陸器
dlqj	砥礪清節
dlqt	大陸氣團
dlr	大陸人
dlr	大陸熱
dlr	登陸熱
dlrh	地利人和
dlrj	地靈人傑
dls	地理師
dls	地老鼠
dls	地論師
dlsb	地裂山崩
dlsc	大陸市場
dlt	登陸艇
dltb	大陸同胞
dlth	地老天荒
dlwz	地理位置
dlwz	德隆望重
dlx	地理學
dlxb	大流行病
dlxp	大陸斜坡
dlxqh	大陸性氣候
dlxqt	大陸性氣團
dlxs	地理先生
dlxs	東量西折
dlychxt	打落牙齒和血吞
dlyd	道路用地
dlyh	典麗矞皇
dlyq	登陸月球
dlzb	地利之便
dlzc	大陸政策
dlzl	凍凌觜臉
dlzx	提溜着心
dlzxxt	地理資訊系統
dlzz	登陸作戰
dm	丟抹
dm	倒抹
dm	典沒
dm	地名
dm	地畝
dmbj	杜門屏跡
dmbr	大謬不然
dmc	躲迷藏
dmd	都馬調
dmdmd	達姆達姆彈
dmdy	大模大樣
dmgl	滇緬公路
dml	玳瑁梁
dmlj	砥名勵節
dmp	大茅埔
dmqlmjjmbw	大目乾連冥間救母變文
dmsx	動脈輸血
dmsy	大模廝樣
dmtm	當面唾罵
dmtt	打沒頭壇
dmty	德懋棠蔭
dmx	動脈血
dmy	玳瑁筵
dmybf	代馬依北風
dmz	打毷氉
dmzx	旦暮朝夕
dn	佃農
dn	喋囁
dn	地暖
dn	嵽嵲
dn	掇弄
dncxxzf	大腦出血性中風
dnfs	地牛翻身
dnfw	地牛發威
dnms	電腦祕書
dnth	鼎鼐調和
dntq	對牛彈琴
dnyy	電腦音樂
dp	丹葩
dp	地坪
dp	地痞
dp	地癖
dp	地皮
dpbr	大品般若
dpcl	大排長龍
dpcx	戴憑重席
dpd	大盆地
dpdy	對品調用
dpgf	豆剖瓜分
dph	大埤湖
dph	大排行
dpkl	道傍苦李
dpl	低頻率
dpl	得票率
dpl	道傍李
dpqn	大破慳囊
dpsz	砥平繩直
dptc	地平天成
dptx	打破頭屑
dpx	地平線
dpxj	獨闢蹊徑
dpxx	地盤下陷
dpxz	東碰西撞
dpycspy	得便宜處失便宜
dpyslpy	得便宜是落便宜
dq	丁彊
dq	佃契
dq	佃權
dq	刀鎗
dq	地勤
dqc	地球村
dqcz	大衾長枕
dqdk	顛乾倒坤
dqfy	地區方言
dqgfh	地球高峰會
dqh	掉鎗花
dqh	的確會
dqh	電器行
dqh	電氣行
dqjj	刀鎗劍戟
dqkx	地球科學
dql	的確良
dqpb	大氣磅礴
dqq	倒旗鎗
dqr	地球人
dqr	地球日
dqrc	的確如此
dqs	地球史
dqs	的確是
dqsg	多錢善賈
dqsw	底棲生物
dqsz	但求塞責
dqsz	掇青拾紫
dqtxz	地區通行證
dqwy	刀鎗無眼
dqx	地區性
dqxb	德淺行薄
dqy	地球儀
dqz	大圈仔
dqz	道茄子
dqzr	帶球撞人
dqzr	得權重任
dr	地熱
dr	大喏
dr	大稔
dr	怛然
dr	澹然
drgf	地若瓜分
drs	都人士
drss	動如參商
drss	怛然失色
drxx	動人心弦
drzwgl	丟入爪哇國裏
ds	丹參
ds	倒熟
ds	哆嗦
ds	地上
ds	地勢
dsb	都市報
dsb	都市病
dsbfmml	大乘百法明門論
dsbzl	到三不着兩
dsbzl	道三不着兩
dscy	東市朝衣
dscz	嫡孫承重
dsd	第三地
dsd	調書袋
dsdg	簞食豆羹
dsf	大晟府
dsfj	大乘佛教
dsg	兜率宮
dsgzx	電視歌仔戲
dsh	倒熟話
dsh	都市化
dshc	得勝回朝
dshj	簞食壺漿
dsj	地稅局
dsj	雕塑家
dsjd	大乘經典
dsjh	都市計畫
dsjj	都市傢俱
dsl	得上來
dsls	丟三落四
dsm	打什麼
dsmj	呆似木雞
dsml	登山驀嶺
dsmrs	都市美容師
dsnly	狄斯奈樂園
dsnly	狄斯耐樂園
dsnly	迪斯尼樂園
dspj	大肆抨擊
dspy	簞食瓢飲
dsq	地上權
dsq	得上去
dsqxl	大乘起信論
dsrbcm	打死人不償命
dssb	掂梢折本
dssc	躉售市場
dssh	堆山塞海
dst	兜率天
dstg	兜率天宮
dsw	地上物
dswz	德深望重
dsx	大三弦
dsxs	東食西宿
dsyjr	都是一家人
dsylq	電視遊樂器
dsyz	淡水養殖
dsz	董事長
dszd	定時炸彈
dszf	都市之肺
dszj	董事長兼
dt	丹荑
dt	倒褪
dt	動彈
dt	地圖
dt	地攤
dtbd	動彈不得
dtc	調頭寸
dtct	對天長嘆
dtcx	短嘆長吁
dtdn	獃頭獃腦
dtf	打嚏噴
dtfd	洞天福地
dtfs	地土風俗
dtg	地頭鬼
dth	地攤貨
dthx	歹徒橫行
dtj	大頭芥
dtj	大頭覺
dtjd	刁天厥地
dtjd	刁天撅地
dtjd	刁天決地
dtld	戴天履地
dtld	頂天履地
dtld	頂天立地
dtpp	掇臀捧屁
dtr	地頭人
dts	地土蛇
dts	地毯式
dts	地頭蛇
dtszqjsh	大唐三藏取經詩話
dttx	刀頭舔血
dtwstgt	地頭文書鐵箍桶
dtx	凍天行
dtxm	東塗西抹
dtxsjh	地圖性視覺化
dtyb	鈿頭雲篦
dtyh	大通銀行
dtz	地鐵站
dtzc	戴天之仇
dw	地位
dw	地望
dw	地維
dw	彈丸
dw	玷污
dwbz	地無不載
dwcy	得未曾有
dwez	達斡爾族
dwgh	地望高華
dwhl	隊伍行列
dwjy	殆無孑遺
dwlz	地無立錐
dwslp	地無三里平
dwtl	地網天羅
dwxf	彈無虛發
dwxj	冬溫夏凊
dwxr	殆無虛日
dwxw	動物纖維
dwzd	彈丸之地
dwzz	睹微知著
dx	刀械
dx	單弦
dx	單行
dx	地下
dx	地匣
dxag	獨弦哀歌
dxb	刀削冰
dxb	單行本
dxb	打細泊
dxbx	丹心碧血
dxbybzb	多行不義必自斃
dxc	地下城
dxd	單行道
dxd	地下的
dxd	地下道
dxd	大溪地
dxdd	獨行大盜
dxdd	獨行獨斷
dxdl	大廈棟梁
dxds	滴修都速
dxds	滴羞都蘇
dxdt	地下電臺
dxdx	抵瑕蹈隙
dxdx	滴羞跌屑
dxf	單行法
dxf	單行犯
dxfd	導向飛彈
dxfg	單行法規
dxfr	地下夫人
dxgc	地下工廠
dxgz	地下工作
dxh	地下化
dxhb	地下核爆
dxhs	地下核試
dxhy	電信行業
dxhz	得匣還珠
dxj	地下莖
dxj	地下街
dxjj	地下經濟
dxjq	大廈將傾
dxjx	單線進行
dxky	倒舄摳衣
dxl	單行路
dxl	得下來
dxlm	砥行立名
dxlx	單弦拉戲
dxm	刀削麪
dxm	打踅磨
dxmm	砥行磨名
dxns	倒行逆施
dxph	搗虛批吭
dxq	得下去
dxqd	大行其道
dxqd	獨行其道
dxqs	獨行其是
dxqz	地下錢莊
dxr	大行人
dxs	地下室
dxs	地下水
dxs	鬥蟋蟀
dxsc	單弦說唱
dxsj	擔雪塞井
dxsm	地下水面
dxsw	地下水位
dxsz	打胸廝撞
dxt	低血糖
dxt	地下鐵
dxtcc	地下停車場
dxtz	地下投資
dxws	地下無雙
dxwt	地下舞廳
dxx	單行線
dxx	大巡行
dxx	大行星
dxx	滴屑屑
dxx	獨行俠
dxxw	地下修文
dxxwl	地下修文郎
dxxz	大學校長
dxy	低血壓
dxy	地形雨
dxyh	地下油行
dxyl	地心引力
dxyx	大學院校
dxyz	地下有知
dxyz	鵰心雁爪
dxz	氮血症
dxzq	大行政區
dxzy	地下資源
dxzy	底下奏樂
dy	侗語
dy	倒景
dy	典鬻
dy	地域
dy	地獄
dybg	調研報告
dybk	大煠八塊
dycs	大隱朝市
dycz	德業長昭
dyd	電熨斗
dydj	朵頤大嚼
dygn	地域觀念
dyh	地獄火
dyh	打野呵
dyh	第一行
dyj	大躍進
dyjd	釣遊舊地
dyjml	大義覺迷錄
dykj	丹楹刻桷
dyl	獨樂樂
dypd	大洋盆地
dypx	帶月披星
dypx	戴月披星
dyq	電樂器
dyqe	的一確二
dyrz	道遠任重
dys	調眼色
dysjx	等腰三角形
dysl	單一稅率
dysq	多言數窮
dythszytz	當一天和尚撞一天鐘
dyx	地域性
dyxf	都俞吁咈
dyxh	恫疑虛喝
dyxh	恫疑虛猲
dyyz	單養養殖
dyz	典獄長
dyz	地窨子
dyz	大月氏
dyz	調研組
dyzbz	獨陽則不長
dz	佃作
dz	佃租
dz	侗族
dz	地主
dz	地做
dzb	翟子悲
dzbj	丟卒保車
dzbz	當着不着
dzcb	棟折榱崩
dzd	地震帶
dzd	彈着點
dzds	調嘴調舌
dzdt	電子地圖
dzf	彈子房
dzg	地主國
dzgm	地震規模
dzgz	大長公主
dzh	地中海
dzhd	地質活動
dzhwkt	電子恆溫空調
dzhxpx	地中海型貧血
dzj	地震局
dzj	大藏經
dzkq	洞中肯綮
dzky	動中窾要
dzl	地址欄
dzl	獃着臉
dzlj	彫章鏤句
dzlj	雕章鏤句
dzlx	地窄路險
dzlx	砥志礪行
dzm	擔仔麪
dzms	電子祕書
dzmzbzz	頂着磨子不知重
dznm	淡妝濃抹
dzplz	蠹啄剖梁柱
dzpm	當者披靡
dzps	地藏菩薩
dzq	地擲球
dzqd	地震強度
dzqx	刀杖器械
dzs	地藏寺
dzsh	斗轉參橫
dzsn	道在屎溺
dzsq	斗重山齊
dzt	彈子檯
dzt	彈珠檯
dztf	大張撻伐
dzw	地藏王
dzwps	地藏王菩薩
dzwz	德尊望重
dzx	代執行
dzx	地質學
dzxh	膽顫心寒
dzxhs	但知行好事
dzxj	膽顫心驚
dzxz	東走西撞
dzy	地震儀
dzyh	電子銀行
dzyjdz	電子郵件地址
dzym	豆重榆瞑
dzyx	大專院校
dzyy	盜跖顏淵
dzyy	電子音樂
dzz	大軸子
dzz	嫡長子
dzz	調陣子
dzzd	佃租制度
dzzgxzz	大軸子裹小軸子
dzzh	地質災害
dzzl	砥柱中流
dzzy	地主之誼
e	ㄜ
e	ㄝ
e	ㄟ
e	ㄣ
e	ㄥ
ea	嗯啊
ea	阿匼
eb	二伯
eb	閼伯
eb	阿保
ebs	阿巴桑
ebzg	阿保之功
ebzl	阿保之勞
ec	恩仇
ec	恩賜
ec	愕眙
ec	訛舛
ec	貳車
ecc	二重唱
ecflb	二重分類表
ecgj	二重國籍
ect	二朝廷
ecx	二重性
ecz	二重奏
ecz	貳臣傳
ed	惡地
ed	阿黨
edz	二地主
edzcls	二韃子喫螺螄
ee	哦哦
ee	啞啞
ee	嗯嗯
ee	砐硪
ee	詻詻
eecc	岋岋惙惙
ef	閼逢
ef	阿附
efg	阿房宮
efgf	阿房宮賦
efzh	二缶鐘惑
eg	阿閣
eh	扼吭
eh	阿好
eh	阿衡
ehfb	扼吭拊背
ehfb	搤肮拊背
ehh	惡哏哏
ehy	二和藥
ej	貳車
ej	阿井
ej	阿膠
ej	額角
ejcb	恩將仇報
ejny	阿金溺銀
ejz	恩給制
el	二陸
el	恩露
el	惡露
el	蛾綠
em	訛謬
em	阿媚
emj	二面角
emtf	阿彌陀佛
emtj	阿彌陀經
en	婀娜
en	婐㛂
en	猗儺
en	𣘨橠
endz	婀娜多姿
enqc	兒女情長
enyxz	兒女英雄傳
eo	呃喔
ep	餓莩
epzd	餓莩載道
epzj	餓殍枕藉
eq	阨窮
eqd	二千石
eqsh	阿其所好
er	啞然
ergy	惡稔貫盈
erhy	惡稔禍盈
erss	啞然失色
ersx	啞然失笑
erwy	啞然無言
erzy	惡稔罪盈
es	二乘
es	哦詩
es	恩賜
es	耳塞
es	耳熟
esbd	二十八調
esbx	二十八宿
esnx	耳熟能詳
esqr	阿順取容
eswx	二十五弦
esx	阿是穴
esxql	惡事行千里
esy	二手菸
esyz	恩深義重
etly	兒童樂園
ew	阿魏
ewbx	恩威並行
ewbz	恩威並著
ewbz	恩威並重
ex	二弦
ex	二絃
ex	惡行
ex	而行
exc	二行程
expx	惡性貧血
exyb	鵝行鴨步
ey	㔩葉
ey	阿諛
ey	阿邑
eyfc	阿諛奉承
eyfy	阿諛逢迎
eyg	耳咽管
eygh	阿諛苟合
eyqc	阿意曲從
eyqf	阿諛趨奉
eyqr	阿諛取容
eysy	阿諛順意
eysz	阿意順旨
eysz	阿諛順旨
ez	二傳
ez	耳重
ez	蛾子
ezg	戹屯歌
ezj	二軸晶
ezj	蚵仔煎
ezmx	蚵仔麪線
ezqs	恩重丘山
ezrs	恩重如山
ezsg	阿尊事貴
ezwj	二朝王醮
f	㐽
f	㑂
f	㒥
f	㓡
f	㔗
fa	富媼
fb	副榜
fb	反哺
fb	幡布
fb	復辟
fb	憤薄
fbcz	福不重至
fbczz	父不償子債
fbd	防波堤
fberdcr	翻把恩人當仇人
fbhy	反本還原
fbhy	返本還原
fbl	分辨率
fbl	發病率
fblp	鳳泊鸞飄
fblw	分辨率爲
fbpd	風波平地
fbs	反不似
fbt	防波堤
fbyq	分薄緣慳
fbys	風伯雨師
fbz	犯不着
fc	伏藏
fc	佛剎
fc	副車
fc	夫差
fc	奉厝
fcbgdt	父仇不共戴天
fccc	輔車脣齒
fccd	覆轍重蹈
fcdc	風馳電掣
fcg	番菜館
fchb	法償貨幣
fcjz	浮沉酒醆
fcls	風餐露宿
fclt	翡翠蘭苕
fclx	風掣雷行
fcns	敷彩泥塑
fcq	飯匙倩
fcsq	風餐水棲
fcss	風餐水宿
fcsxddhxt	蜂巢式行動電話系統
fcxc	復仇雪恥
fcxddy	放長線釣大魚
fcxy	輔車相依
fcys	風餐雨宿
fcz	負成長
fczc	覆車之轍
fczd	方寸之地
fczl	逢場作樂
fczs	非常重視
fczy	非常重要
fczz	覆車之轍
fd	乏地
fd	伏地
fd	佛地
fd	墳地
fd	奉調
fdbl	楓丹白露
fdc	房地產
fdcgtjj	房地產共同基金
fdcs	房地產商
fdcy	房地產業
fdd	非得到
fddq	發達地區
fddt	福地洞天
fdft	覆地翻天
fdhl	浮動匯率
fdkd	法定空地
fdkt	飛彈快艇
fdkz	伏地扣子
fdl	放大率
fdl	服低捋
fdlc	蜚短流長
fdlc	飛短流長
fdls	飛遯離俗
fdmg	肥遯鳴高
fdqc	復蹈其轍
fdqc	復蹈前轍
fdqz	復蹈其轍
fdqz	復蹈前轍
fdsr	伏地聖人
fdsz	放蕩弛縱
fdszx	副都市中心
fdts	伏地挺身
fdxc	髮短心長
fdxq	法定血親
fdy	防彈衣
fdys	鋒鏑餘生
fdz	犯得着
fdzbl	法定準備率
febj	犯而不校
ff	仿佛
ff	宓妃
ff	幡幡
ff	彷彿
ff	放番
ffbrhl	蜂房不容鵠卵
ffcp	放富差貧
ffd	反飛彈
ffsf	番番是福
ffxs	非法行事
ffxw	非法行爲
ffyt	沸反盈天
ffyy	沸沸揚揚
fg	俘馘
fg	幡蓋
fg	服賈
fg	枹鼓
fg	沸涫
fgbe	奉公不阿
fgbq	負固不悛
fgbx	婦姑勃谿
fgctl	富貴草頭露
fgd	范公堤
fghz	附過還職
fgjg	焚膏繼晷
fgl	覆蓋率
fgly	浮光掠影
fglztz	糞缸裏擲骰子
fgml	豐功懋烈
fgnx	返躬內省
fgsl	豐功盛烈
fgt	范公堤
fgw	副睪丸
fgxp	鳳冠霞帔
fgxy	枹鼓相應
fgyj	販官鬻爵
fgzx	反躬自省
fh	分行
fh	奉還
fh	方罫
fh	楅衡
fh	番悔
fhbb	分行布白
fhc	鳳還巢
fhcj	封侯賜爵
fhhl	紛紅駭綠
fhjm	封胡羯末
fhsj	封侯賜爵
fhxl	伏虎降龍
fhxz	飛鴻雪爪
fhz	副會長
fhz	發諢子
fj	俯角
fj	俸給
fj	副角
fj	副車
fj	反詰
fjbs	法家拂士
fjcc	輔車脣齒
fjfz	浮家泛宅
fjghg	斐濟共和國
fjjh	翻江攪海
fjpqkkl	飛機派遣可靠率
fjr	斐濟人
fjr	汾沮洳
fjtf	發奸擿伏
fjtf	發姦擿伏
fjx	分角線
fjxq	反經行權
fjxy	輔車相依
fjyy	佛教音樂
fk	俯瞰
fk	啡咖
fk	憤愾
fk	樊噲
fk	鳧葵
fkdh	發科打諢
fkfd	防空飛彈
fl	佛戾
fl	俘擄
fl	忿戾
fl	浮掠
fl	琺瑯
flbsjwyz	法律不溯既往原則
flc	琺瑯彩
flcx	服露餐霞
fldc	飛流短長
fldf	風流調法
flet	焚林而畋
flf	翻兩番
flfq	番來覆去
flhq	粉吝紅慳
flhs	分釐毫絲
flht	反老還童
flht	返老還童
flk	分釐卡
flsz	分裂生殖
flt	豐樂亭
fltb	富埒陶白
fltc	反戾天常
flthw	氟氯碳化物
fltt	風流倜儻
fltz	富埒天子
flxw	法律行爲
flyj	風流蘊藉
flyj	風流醞藉
flz	琺瑯質
flz	番荔枝
flzy	蕃籬之鷃
fm	分娩
fm	忿懣
fm	憤懣
fm	朏明
fm	煩懣
fmb	番木鱉
fmbl	浮名薄利
fmbl	鋒芒畢露
fmcc	反目成仇
fmd	放牧地
fmdw	駙馬都尉
fmg	番木瓜
fmjb	風魔九伯
fmjq	方面兼圻
fml	番麥粒
fmlxxtzy	父母兩系血統主義
fmtfd	飛毛腿飛彈
fmtz	佛蒙特州
fmy	奉氂纓
fmzy	鳳鳴朝陽
fn	分蘗
fn	朏朒
fn	粉嫩
fn	紛呶
fn	紛拏
fnj	分蘗節
fnj	犯牛勁
fnmt	膚橈目逃
fnq	分蘗期
fnrs	豐年稔歲
fp	分剖
fp	奉被
fp	朏魄
fp	紛披
fp	紛葩
fpf	奉蘋蘩
fplc	浮皮潦草
fpp	腹便便
fq	分枝
fq	分畦
fq	富彊
fq	服闋
fq	沸泉
fqcd	番茄炒蛋
fqdex	反其道而行
fqhy	番茄花園
fqj	番茄醬
fqkl	富強康樂
fqqh	放情丘壑
fqqy	鳧趨雀躍
fqrc	飯糗茹草
fqs	番茄素
fqtl	服氣吞露
fqwgszc	夫妻無隔宿之仇
fqyb	分淺緣薄
fqyb	楓橋夜泊
fqyq	分淺緣慳
fr	幡然
fr	斐然
fr	沸然
fr	沸熱
fr	紛糅
frbs	怫然變色
frby	怫然不悅
frcs	婦人長舌
frcs	繁榮昌盛
frct	廢然長嘆
frcz	斐然成章
frhw	幡然悔悟
frjs	豐容靚飾
frsx	發人深省
frxf	斐然向風
frxw	放任行爲
fryz	方枘圜鑿
fs	伏伺
fs	俛首
fs	封禪
fs	廢弛
fs	沸水
fsby	菲食薄衣
fscs	封豕長蛇
fscx	飛書馳檄
fsd	防沙堤
fsdg	富商大賈
fsg	佛手柑
fshl	風聲鶴唳
fsj	反射角
fsl	氟塑料
fsl	番石榴
fsl	發生率
fsls	風飧露宿
fsmc	福壽綿長
fspb	番薯椪餅
fspp	腹笥便便
fsq	房宿錢
fssfyq	沸水式反應器
fssm	發生什麼
fsss	風飧水宿
fst	分水隄
fst	防沙堤
fste	俛首帖耳
fstk	撫尸慟哭
fstm	俛首聽命
fsx	非塑性
fsxs	賦食行水
fsz	封神傳
fszc	附膻逐臭
fszd	發生重大
fszh	附膻逐穢
fszk	負乘致寇
fszs	蝮蛇螫手
fszx	飛書走檄
fszz	俛首自招
ft	反彈
ft	府帑
ft	沸湯
ft	沸騰
ft	番騰
ftc	佛圖澄
ftel	紛沓而來
ftfd	番天覆地
ftfd	翻天覆地
ftg	番攤館
ftjf	發擿姦伏
ftmd	父天母地
ftnd	煩天惱地
ftpp	反彈琵琶
ftsj	氟碳塑膠
ftxd	法天象地
ftyr	風調雨潤
ftys	風調雨順
ftz	飛跎傳
ftzc	分天之仇
ftzf	佛頭着糞
fw	帗舞
fw	粉渦
fw	罘網
fw	蕃廡
fw	蕃蕪
fwcsr	福無重受日
fwgn	奉爲圭臬
fwhy	服務行業
fwq	樊於期
fwxx	法外行兇
fx	仿行
fx	伏行
fx	反省
fx	奉檄
fx	奉行
fxbl	分星擘兩
fxcc	風行草從
fxcm	風行草靡
fxcy	風行草偃
fxd	發祥地
fxdj	風行電擊
fxgp	發行股票
fxgs	奉行故事
fxj	發行價
fxj	飛行家
fxjb	飛行甲板
fxjd	復興基地
fxjg	發行價格
fxjg	繁弦急管
fxl	發行量
fxljqgjzs	發行量加權股價指數
fxq	飛行器
fxqbq	飛行情報區
fxql	反省起來
fxr	發行人
fxrs	方興日盛
fxs	飛行傘
fxsq	馮諼燒券
fxsr	發行首日
fxss	風行水上
fxtj	馮諼彈鋏
fxxn	煩囂喧鬧
fxy	飛行員
fxy	飛行雲
fxys	風行一時
fxzf	繁刑重賦
fxzl	繁刑重斂
fy	俛仰
fy	偪陽
fy	傅說
fy	反景
fy	坊隅
fybj	蕃衍不絕
fybz	傅說版築
fycd	飛雲掣電
fycg	風檐寸晷
fycg	風簷寸晷
fycw	魴魚赬尾
fycz	風雲叱吒
fyd	發源地
fydt	撫膺大慟
fydt	方言地圖
fyfd	飛魚飛彈
fyhzy	非一狐之腋
fykhc	鮒魚困涸轍
fykhz	鮒魚困涸轍
fyls	敷衍了事
fyqb	罰一勸百
fyqb	諷一勸百
fysd	飛也似的
fysz	敷衍塞責
fytf	發隱擿伏
fyts	敷衍搪塞
fywk	負隅頑抗
fywz	飛燕外傳
fyxb	蜂腰削背
fyyl	風雲月露
fyz	副議長
fyz	飛煙傳
fyzl	浮雲朝露
fyzl	發揚踔厲
fyzs	逢掖之士
fyzt	紛紜雜沓
fz	分枝
fz	封殖
fz	封貯
fz	幡幟
fz	府宅
fzbe	方正不阿
fzcd	覆轍重蹈
fzcl	風燭草露
fzcx	扶正黜邪
fzcxr	非洲出血熱
fzd	伐子都
fzfz	分株繁殖
fzgd	番張跟斗
fzjtmq	宓子賤彈鳴琴
fzl	反撞力
fzl	犯罪率
fzl	附着力
fzmb	復子明辟
fzs	番子手
fzsj	泛珠三角
fzsy	負重涉遠
fztl	紛至沓來
fzxg	反軸心國
fzxw	犯罪行爲
fzy	房中樂
fzyx	匪朝伊夕
fzz	放尊重
fzz	負增長
fzzh	父債子還
fzzy	負重致遠
g	㒴
g	㒷
g	㓋
g	㓚
g	㓡
ga	乾熬
ga	關隘
gajz	公安局長
gan	乾阿嬭
gayy	苟安一隅
gb	乾冰
gb	乾巴
gb	乾杯
gb	乾癟
gb	乾罷
gbb	乾剝剝
gbb	乾巴巴
gbbr	剛愎不仁
gbcl	乾巴疵咧
gbd	高爆彈
gbfz	根蘗繁殖
gbgzx	廣播歌仔戲
gbj	鬼不覺
gbk	鬼擘口
gbkm	功不可沒
gbl	改不了
gbl	管不了
gbl	過不了
gbl	顧不了
gblb	官卑祿薄
gblnmd	管不了那麼多
gbsc	公報私仇
gbsc	官報私仇
gbwz	宮本武藏
gbxc	剛愎性成
gbyj	各抱一角
gbz	光膀子
gbz	搆不着
gbz	管不着
gbzlwxzlc	肐膊折了往袖子裏藏
gbzy	剛愎自用
gbzy	剛褊自用
gbzz	恭本正傳
gc	乖舛
gc	乾擦
gc	乾柴
gc	乾產
gc	乾脆
gccc	貫穿馳騁
gccd	滾車轍的
gccltwglq	棺材出了討挽歌郎錢
gcdpgcs	隔重肚皮隔重山
gcf	公差費
gchd	改朝換代
gcjd	規重矩疊
gcl	乾茨臘
gcld	攻城掠地
gcld	攻城略地
gclh	乾柴烈火
gcly	更長漏永
gcmd	更長夢短
gcp	工尺譜
gcpw	根椽片瓦
gcq	乾茶錢
gcs	乾村沙
gcs	廣長舌
gcsd	綱常掃地
gcsj	工程塑膠
gcsk	乾脆爽快
gcsx	高才碩學
gcsz	孤雌生殖
gcx	鼓吹弦
gcxm	功成行滿
gcy	鼓吹樂
gcyj	宮車晏駕
gcz	鬼攛揝
gczd	滾車轍的
gczx	貫徹執行
gd	乖調
gd	乾爹
gd	乾等
gd	公地
gd	公石
gdb	公道伯
gdb	鬼打鈸
gdbs	扛鼎拔山
gdc	乾電池
gdd	孤調調
gdd	格地地
gdd	骨都都
gdddf	關東都督府
gddj	規定地價
gddt	古調獨彈
gdfl	公地放領
gdfl	耕地放領
gdgd	嘓都嘓都
gdgs	佹得佹失
gdh	骨董行
gdhl	固定匯率
gdk	噶大克
gdl	乾打雷
gdl	幹得了
gdll	固定利率
gdml	瓜地馬拉
gdmlghg	瓜地馬拉共和國
gdmls	瓜地馬拉市
gdp	刮地皮
gdp	噶當派
gdp	括地皮
gdpk	割地賠款
gdq	刮地器
gdq	滾地球
gdq	疙瘩腔
gdq	該地區
gdqh	高地氣候
gds	扛鼎士
gds	疙瘩事
gdt	疙瘩湯
gdtd	感動天地
gdtd	肝膽塗地
gdw	關都尉
gdx	工地秀
gdxx	高等學校
gdy	乾瞪眼
gdy	固定液
gdyh	光大銀行
gdyy	古典音樂
gdz	過得着
gdzp	高調照片
gdzr	摑打撾揉
gdzs	高度重視
gdzxb	乾吊着下巴
gdzxxc	廣東住血吸蟲
gdzy	固定重音
gdzy	甘地主義
ge	聒耳
gej	共軛角
gesq	盥耳山棲
gexs	改惡行善
gez	乾兒子
gf	乾粉
gf	乾肥
gf	乾飯
gf	括髮
gf	更番
gfbl	高分辨率
gfbz	國防部長
gfdc	國富調查
gfdp	瓜分豆剖
gfgd	鬼飯疙瘩
gfhb	鼓腹含哺
gfjj	高風勁節
gflm	高鳳流麥
gfqs	恭逢其盛
gfqs	躬逢其盛
gg	㶁㶁
gg	乾果
gg	乾稿
gg	乾股
gg	乾館
ggblcs	狗改不了喫屎
ggbq	桂宮柏寢
ggcb	功過參半
ggcs	概括承受
ggd	高格調
ggdd	呱呱墮地
ggdd	疙疙瘩瘩
ggdz	功高德重
ggem	股肱耳目
gggd	矜寡孤獨
gggj	亙古亙今
ggj	咯咯叫
ggj	括括叫
ggj	聒聒叫
ggjj	乾乾淨淨
ggjm	尷尬局面
ggjs	公共給水
ggl	刮刮樂
ggl	高句麗
ggld	躬耕樂道
ggll	光怪陸離
ggls	滾瓜爛熟
ggqj	詭怪奇譎
ggs	咯咯聲
ggsd	觀光勝地
ggssbld	公共設施保留地
ggssyd	公共設施用地
ggwy	亙古未有
ggwz	功高望重
ggx	咯咯笑
ggxz	公共行政
ggxz	冠蓋相屬
ggyqxzy	觀光遊憩性資源
ggyy	哽哽咽咽
ggzd	呱呱墜地
ggzj	干戈載戢
ggzl	股肱之力
ggzl	高官重祿
ggzx	咯咯作響
gh	乾和
gh	乾嚎
gh	乾旱
gh	乾涸
gh	乾耗
ghc	乾貨船
ghcc	功墮垂成
ghf	乾回付
ghg	歸還給
ghgh	孤鴻寡鵠
ghgl	寡鵠孤鸞
ghgy	各行各業
ghl	乾霍亂
ghmc	龔黃滿朝
ghrgs	隔行如隔山
ghs	肝火盛
ghyq	乾餱以愆
ghz	古惑仔
ghzj	膏肓之疾
gj	乖覺
gj	乖角
gj	乾井
gj	乾季
gj	乾急
gjbd	感覺不到
gjcb	古井重波
gjcs	故技重施
gjcy	故伎重演
gjd	根據地
gjdb	詭譎多變
gjdl	國家地理
gjdqwln	國際地球物理年
gjds	掛角讀書
gjfg	句踐復國
gjfs	綱紀廢弛
gjgd	詭譎怪誕
gjh	估價行
gjhx	告假還鄉
gjj	廣角鏡
gjjt	廣角鏡頭
gjkx	乖覺可喜
gjll	乾淨俐落
gjmy	干將莫邪
gjp	噶舉派
gjpc	國家賠償
gjpcf	國家賠償法
gjqg	感覺器官
gjqsyh	國際清算銀行
gjs	會稽山
gjsc	國際索償
gjsc	高舉深藏
gjsl	乾淨爽利
gjtd	功均天地
gjws	廣緝文書
gjwx	詭譎無行
gjxm	蝸角虛名
gjxwzy	國家行爲主義
gjyd	蝸居蟻蛭
gjyj	宮車晏駕
gjyt	蝸角蠅頭
gjyyt	國家音樂廳
gjz	供給制
gjzc	會稽之恥
gjzd	功均柱地
gjzd	國家重點
gjzh	感覺真好
gjzl	高爵重祿
gjzz	蝸角之爭
gk	乾咳
gk	乾哭
gk	乾枯
gk	乾渴
gk	廣欬
gkb	乾刻版
gkcs	概括承受
gkfx	公開發行
gkmc	公筷母匙
gkng	高悝匿孤
gkqs	鬼瞰其室
gktt	高空彈跳
gl	乖戾
gl	乾冷
gl	乾料
gl	乾禮
gl	乾糧
glb	佝僂病
glb	功勞簿
glb	功率比
glb	功率表
glbzflz	羹裏不着飯裏着
glcc	顧慮重重
gld	乾落得
gld	高冷地
gldsc	高冷地蔬菜
glf	咖喱粉
glf	咖喱飯
glfy	甘露法雨
glgq	攪來攪去
glh	哥倆好
glhq	羹藜唅糗
glhx	告老還鄉
glj	咖喱雞
gll	乖離率
gll	光了了
gll	光陸離
gll	括剌剌
gllz	岡連嶺屬
glp	虼螂皮
gls	裹螺螄
gls	高麗參
glsj	甘露水漿
glszw	甘羅說趙王
glt	乾撂臺
glt	光辣撻
glt	蛤蜊湯
glx	紇剌星
glxx	公立學校
glys	功率因數
glz	咖喱汁
glz	甘露子
glz	穀梁傳
glz	關捩子
glzb	甘露之變
glzx	甘露滋心
glzy	剛戾自用
gm	乖謬
gm	乾媽
gm	乾梅
gm	乾沒
gm	乾麪
gmc	瓜蔓抄
gmdesl	戤米囤餓殺了
gmds	孤眠獨宿
gmf	歸謬法
gmgy	怪模怪樣
gmjl	鬼魅伎倆
gml	公母倆
gmlhxx	公門裏好修行
gmm	乾妹妹
gmp	乾篾片
gmsx	劌目鉥心
gmtj	龜毛兔角
gmxx	公門修行
gmyc	冠冕衣裳
gmyh	國民銀行
gmypyy	國民樂派音樂
gmzzhxx	公門之中好修行
gn	乾娘
gn	乾暖
gn	圭臬
gn	括囊
gn	淈泥
gnc	乾奴才
gndj	甘迺迪角
gne	乾女兒
gngs	括囊拱手
gnsl	括囊守祿
gntd	肝腦塗地
go	乾嘔
gp	乾片
gp	冠帔
gp	皋比
gp	鋼胚
gp	關聘
gpd	高平調
gpdf	瓜剖豆分
gphl	掛牌匯率
gpld	甘貧樂道
gpt	軋姘頭
gptzhll	股票投資獲利率
gpx	乾撇下
gpxj	各闢蹊徑
gpz	拐裨子
gq	乾喬
gq	乾虔
gq	乾親
gq	共棲
gq	古槧
gqbzbmy	乾敲梆子不賣油
gqd	夠情調
gqecz	鋼琴二重奏
gqgd	怪腔怪調
gqj	乾親家
gqns	搞七捻三
gqts	苟且唐塞
gqws	廣緝文書
gqyz	雇妻鬻子
gqz	枸杞子
gqzb	官情紙薄
gr	乾熱
gr	傀然
gr	嬀汭
gr	禬禳
gr	聒擾
grb	光榮榜
grcf	骨肉重逢
grdh	賈人渡河
grhm	割肉還母
grsx	賈儒商秀
grxw	個人行爲
gs	乾死
gs	乾溼
gs	乾澀
gs	乾爽
gs	乾瘦
gsbs	過盛必衰
gscc	拱手垂裳
gscz	公司重整
gscz	高山重嶂
gsd	歸屬地
gsd	高升調
gsdl	瓜熟蒂落
gsex	拱手而降
gsgc	寡宿孤辰
gsgs	攪三攪四
gsh	戈什哈
gshh	公司行號
gsj	乾屎橛
gsjx	高山景行
gsjzy	宮商角徵羽
gsl	關稅率
gsm	幹什麼
gsm	搞什麼
gspz	官衫帔子
gss	乾生受
gssc	鬼使神差
gstd	關山迢遞
gstx	拱手投降
gstz	根生土長
gswc	貴霜王朝
gsx	弓上弦
gsxw	公示行爲
gsxw	該死行瘟
gsxy	告朔餼羊
gsyh	工商銀行
gsz	乾生子
gsz	梏十指
gsz	賈豎子
gsz	高僧傳
gszf	貫手着棼
gszl	果熟自落
gszz	高速增長
gt	乾苔
gt	乾颱
gt	公帑
gt	國帑
gt	埂堤
gtbq	葛天八闋
gtc	軋頭寸
gtdd	感天動地
gtdx	高堂大廈
gtgj	共同感覺
gthd	改天換地
gthd	高天厚地
gthy	鋼鐵行業
gtjd	狗屠角牴
gtl	古天樂
gtlx	躬體力行
gtmedj	過屠門而大嚼
gtmf	弓調馬服
gtsk	乾啼濕哭
gtssj	狗頭上生角
gtt	光撻撻
gw	乾塢
gw	傀偉
gw	句吳
gw	句無
gw	梏亡
gwcc	隔屋攛椽
gwdb	功微德薄
gwlx	公文旅行
gwmj	拐彎抹角
gwwjz	睪丸未降症
gwxd	規外行動
gwxj	歸遺細君
gwxw	軌外行爲
gwzl	歌舞作樂
gwzl	高位重祿
gx	乾洗
gx	乾笑
gx	乾薪
gx	光纖
gx	公廨
gxbj	過隙白駒
gxbs	躬先表率
gxc	光行差
gxd	關係調
gxdj	鉤心鬥角
gxdl	光纖電纜
gxf	慣行犯
gxfd	光纖飛彈
gxg	垓下歌
gxgm	剛行剛驀
gxgx	狗心狗行
gxgz	改弦更張
gxh	汞溴紅
gxhx	槁項黃馘
gxj	柑香酒
gxjb	規行矩步
gxjj	孤行己見
gxjj	躬行節儉
gxjy	孤行己意
gxjz	規行矩止
gxl	貢獻率
gxl	高效率
gxlt	狗血淋頭
gxlx	狗行狼心
gxmm	甘心瞑目
gxpl	狗血噴臉
gxpt	狗血噴頭
gxqs	各行其是
gxqs	改行遷善
gxqz	各行其志
gxrj	甘心如薺
gxsj	共襄盛舉
gxsj	歸心似箭
gxsj	躬行實踐
gxss	廣行善事
gxst	供需失調
gxsx	觀釁伺隙
gxtf	恭行天罰
gxtf	龔行天罰
gxtl	官星透露
gxtx	光纖通訊
gxtxxt	光纖通信系統
gxtz	高血糖症
gxw	光纖維
gxw	高纖維
gxwj	廣廈萬間
gxx	鬼葸戲
gxxy	鬼行胸臆
gxxz	廣夏細旃
gxy	管弦樂
gxy	高血壓
gxyc	改弦易轍
gxyc	更弦易轍
gxyd	改弦易調
gxym	功行圓滿
gxyt	管弦樂團
gxyz	改弦易張
gxyz	改弦易轍
gxyz	更弦易轍
gxzf	甘馨之費
gy	乾咽
gy	乾噦
gy	公鑰
gy	古樂
gy	咎繇
gyby	高義薄雲
gyc	公冶長
gycc	國有財產
gycc	鬼影幢幢
gyd	管樂隊
gydd	高牙大纛
gyfl	公用費率
gygx	改玉改行
gyj	乾衣機
gyj	軋一腳
gyjj	乾圓潔淨
gyjl	鬼蜮伎倆
gymn	剛毅木訥
gyq	管樂器
gyqx	瑰意琦行
gyrxj	光陰如隙駒
gysc	各有所長
gysj	光陰似箭
gysr	姑射神人
gyss	光陰似水
gysyfl	公用事業費率
gyt	乾嚥唾
gytd	公有土地
gytd	國有土地
gytg	貢禹彈冠
gytz	光陰彈指
gyx	郃陽縣
gyxt	鼓樂喧天
gyy	骨崖崖
gyyc	改轅易轍
gyyd	工業用地
gyyh	國有銀行
gyymzzt	乾魚與貓作枕頭
gyyz	改轅易轍
gyz	乾眼症
gyz	公羊傳
gyz	潙仰宗
gyz	關雲長
gyzd	膏腴之地
gyzmd	工業殖民地
gyzx	鼓勇直行
gz	䀇子
gz	乾折
gz	乾燥
gz	乾着
gz	光宅
gzbb	袞州八伯
gzbe	公正不阿
gzbe	剛正不阿
gzcy	公衆參與
gzd	狗仔隊
gzd	鎘中毒
gzdd	工作地點
gzdz	構造地震
gzfb	躬自菲薄
gzgj	高曾規矩
gzgz	咯吱咯喳
gzgz	鉤輈格磔
gzgzd	嘓啅嘓啅的
gzh	乾燥花
gzhs	扛子火燒
gzj	乾燥劑
gzj	乾燥機
gzj	乾着急
gzjx	各自進行
gzjy	鉤爪鋸牙
gzkgd	糕仔崁古道
gzl	乾支剌
gzl	果子露
gzp	軋支票
gzq	乾燥器
gzqc	各展其長
gzqh	乾燥氣候
gzrj	甘之如薺
gzrj	骨顫肉驚
gzsj	功在社稷
gzsx	官止神行
gzx	乾燥箱
gzx	歌仔戲
gzx	骨殖匣
gzxc	果擲行車
gzxl	工作效率
gzxx	貴族學校
gzy	更重要
gzyd	改張易調
gzz	乾支支
gzz	疙顫顫
gzz	高增長
gzzd	工作重點
gzzfszgd	趕着增福神着棍打
gzzg	國之楨榦
h	㑮
h	㑰
h	㑵
h	㑹
h	㒈
ha	寒燠
ha	麾安
hadl	黑暗大陸
hb	侯伯
hb	厚薄
hb	合窆
hb	后辟
hb	哈伯
hbbc	厚彼薄此
hbbwqz	虎豹不外其爪
hbcl	禍必重來
hbcs	河伯從事
hbdc	緩步代車
hbdj	緩步代車
hbdl	赫柏定律
hbdq	華北地區
hbdx	禍不單行
hbgf	含哺鼓腹
hbgje	貨幣供給額
hbl	回報率
hbl	好不了
hbl	活不了
hblx	虎步龍行
hbmzqcz	黃柏木作磬槌子
hbqf	河伯娶婦
hbs	後半晌
hbs	河泊所
hbs	渾不似
hbs	黃蘗山
hbsz	河伯使者
hbt	黃百韜
hbtkwyj	哈伯太空望遠鏡
hbwt	呵壁問天
hbx	花斑癬
hbxs	毫不遜色
hbxx	緩步徐行
hbyx	懷寶夜行
hbz	合不着
hbz	淮北枳
hbz	黃蘗宗
hbzd	後不着店
hbzlj	虎賁中郎將
hbzy	狠愎自用
hc	何曾
hc	卉裳
hc	呵叱
hc	呵斥
hc	喝參
hcbb	厚此薄彼
hcc	黃澄澄
hcc	黑沈沈
hcdd	緩衝地帶
hcfd	鶴長鳧短
hcfp	還淳反樸
hcfp	還淳返樸
hch	琿春河
hch	謊喳呼
hcj	後車戒
hcjc	花攢錦簇
hcjc	花簇錦攢
hcky	涸轍枯魚
hcll	酣暢淋漓
hclz	胡吹亂謅
hcqd	喉長氣短
hcql	涸轍窮鱗
hcqy	涸轍窮魚
hcs	琿春市
hcsc	喙長三尺
hcsj	很長時間
hctj	禍從天降
hcwf	化鴟爲鳳
hcx	琿春縣
hcxs	諢詞小說
hcxw	合成纖維
hcy	輝長岩
hcyq	合成樂器
hcyt	薈萃一堂
hczf	涸轍之鮒
hczk	涸轍之枯
hczy	涸轍之魚
hczz	橫衝直撞
hd	互調
hd	何地
hd	呵凍
hd	呵導
hd	哏毒
hdbceb	皇帝不差餓兵
hdbls	洪都百鍊生
hdct	畫地成圖
hdcx	昏定晨省
hddq	華東地區
hddz	海底地震
hdeq	畫地而趨
hdf	好地方
hdghg	海地共和國
hdk	還得快
hdls	宏都拉斯
hdlsghg	宏都拉斯共和國
hdq	還得起
hds	海地斯
hds	荒地稅
hdt	核彈頭
hdt	紅地毯
hdwl	畫地爲牢
hdww	劃地爲王
hdwy	畫地爲獄
hdxl	寒地訓練
hdy	活地獄
hdyt	撼地搖天
hdz	合得着
hdzx	畫地自限
he	姮娥
hebg	怙惡不改
hebphx	海爾波普彗星
hebq	怙惡不悛
hebq	懷惡不悛
hebq	諱惡不悛
hej	合恩角
hepphx	海爾波普彗星
hf	和番
hf	涸鮒
hf	行分
hf	酣放
hf	鵠髮
hfbf	海沸波翻
hfddy	候風地動儀
hfey	喝風痾煙
hfhf	海沸河翻
hfhy	喝風呵煙
hfjf	海沸江翻
hfm	皇甫謐
hfmz	呵佛罵祖
hfsl	海沸山裂
hfsy	海沸山搖
hfyh	匯豐銀行
hg	含括
hg	壑谷
hg	扞格
hg	橫亙
hg	沆溉
hgbj	厚古薄今
hgbjh	韓國八角會
hgbr	扞格不入
hgbt	扞格不通
hgcj	含垢藏疾
hgdz	咳歌打戰
hgfr	撝戈反日
hghj	海乾河盡
hghs	黃乾黑瘦
hghw	酣歌恆舞
hgj	烘乾機
hgl	合格率
hgs	湖廣熟
hgsn	火耕水耨
hgtk	宏觀調控
hgyd	胡歌野調
hgzs	黃閣紫樞
hh	呵呵
hh	呵喝
hh	呵會
hh	呵護
hh	哏哏
hhb	火浣布
hhbl	忽忽不樂
hhbpy	好貨不便宜
hhbs	火浣布衫
hhczy	行行出狀元
hhd	核黃疸
hhdx	呵呵大笑
hhdz	鴻鵠大志
hhex	緩緩而行
hhgx	貨賄公行
hhgx	賄貨公行
hhh	呵呵呵
hhhg	河涸海乾
hhhxy	河海航行員
hhj	浣花集
hhj	還魂記
hhlccl	花卉冷藏處理
hhpz	哄嚇騙詐
hhr	浣花日
hhrl	鼾齁如雷
hhs	火花塞
hhss	浩浩湯湯
hhsy	行行蛇蚓
hhw	回鶻文
hhx	浣花溪
hhxk	行號巷哭
hhxx	哄哄翕翕
hhzz	蝎蝎螫螫
hhzz	鴻鵠之志
hj	何炅
hj	合巹
hj	后稷
hj	呵禁
hj	壞疽
hjbc	好景不長
hjbg	厚今薄古
hjcm	昏鏡重明
hjcm	昏鏡重磨
hjcz	狐假鴟張
hjd	火箭彈
hjd	紅茄苳
hjdd	黃金地帶
hjdzx	環境地質學
hjh	行家話
hjhh	好借好還
hjhw	狐藉虎威
hjj	後車戒
hjjd	海軍基地
hjlzd	海軍陸戰隊
hjmc	胡攪蠻纏
hjmslbh	行家莫說力把話
hjpp	擐甲披袍
hjqmd	行家瞧門道
hjqz	緩急輕重
hjrz	戶給人足
hjsd	壺漿塞道
hjsg	混嚼舌根
hjtg	晦跡韜光
hjty	海角天涯
hjxz	戶籍行政
hjzm	花巾着目
hk	含括
hk	昏瞶
hk	紅檜
hk	行口
hk	行庫
hkdc	戶口調查
hkf	喝咖啡
hkjz	戶口校正
hkl	很快樂
hkmb	戶口名簿
hks	行口商
hkxx	恨苦修行
hkxx	航空學校
hl	匯率
hl	和樂
hl	咍樂
hl	哈喇
hl	寒露
hlbs	毫釐不爽
hlbw	何樂不爲
hlbx	賄賂并行
hlbz	航路標識
hlcd	轟雷掣電
hlcj	話裏藏鬮
hld	還了得
hlfs	鶴唳風聲
hlg	好了歌
hlg	歡樂谷
hlgx	貨賂公行
hlgx	賄賂公行
hlheasn	河裏孩兒岸上娘
hlhg	河落海乾
hlj	後掠角
hlj	紅露酒
hlkj	潢潦可薦
hll	獲利率
hll	黑婁婁
hllmdsmy	葫蘆裏賣的甚麼藥
hllt	虎略龍韜
hlml	胡擄忙亂
hlqb	汗流洽背
hlqk	壺裏乾坤
hlql	毫釐千里
hlql	豪釐千里
hlrm	涸鱗濡沫
hls	花露水
hls	行列式
hlsrf	行列輸入法
hlss	郝隆晒書
hlsxtq	黃連樹下彈琴
hltz	鶻崙吞棗
hlwj	含蓼問疾
hlx	獲鹿縣
hlxb	汗流洽背
hly	鶻鴒眼
hlyl	鶴林玉露
hlyrsls	哄了一日是兩晌
hlzc	毫釐之差
hlzq	韓盧逐逡
hm	和墨
hm	和麪
hm	好麼
hm	昏瞀
hm	沆漭
hmbbsa	好馬不鞴雙鞍
hmc	胡蔓草
hmck	蛤蟆吵坑
hmd	蛤蟆蹲
hmd	黃梅調
hmf	紅毛番
hmj	荒謬劇
hmjl	荒謬絕倫
hmjx	鵠面鳩形
hml	蝦蟆陵
hmnx	鵠面鳥形
hmps	晦盲否塞
hmssh	侯門深似海
hmt	胡蔓藤
hmtzdpzl	蝦蟆跳在戥盤子裏
hmxs	荒謬小說
hmz	蝦蟆子
hn	和弄
hn	寒瘧
hn	火捻
hn	花呢
hn	還你
hndg	火耨刀耕
hndq	華南地區
hnj	淮南桔
hnjg	花奴羯鼓
hns	後腦杓
hnsb	呼奴使婢
hntbxzq	海南特別行政區
hntjbj	混凝土攪拌機
hnz	火捻子
ho	好哦
hp	厚朴
hp	含葩
hp	和牌
hp	橫披
hp	虎貔
hpd	海埔地
hphz	合浦還珠
hpj	海埔姜
hpjgxx	黃埔軍官學校
hpl	黃丕烈
hpm	橫剖面
hppl	呵脬捧卵
hpty	黃埔條約
hpx	海螵蛸
hpxsd	海埔新生地
hpz	壞坯子
hpz	黃埔鎮
hpzh	合浦珠還
hq	呵欠
hq	搳拳
hq	撝謙
hq	歡洽
hq	海鰌
hqcc	浩氣長存
hqds	黃麯毒素
hqgl	汗洽股慄
hqlt	呵欠連天
hqmm	含情脈脈
hqns	河清難俟
hqqs	蠖屈求伸
hqsc	黃雀伺蟬
hqsd	荷槍實彈
hqtq	懷鉛提槧
hqwq	懷鉛握槧
hqyh	花旗銀行
hr	暍人
hr	澒溶
hr	砉然
hr	謋然
hr	貉絨
hrbcs	好人不長壽
hrbj	渾然不覺
hrey	禍稔惡盈
hrl	或然率
hrsx	宏儒碩學
hrxq	禍稔蕭牆
hrxw	豁然省悟
hryq	鶻入鴉羣
hryy	黑人音樂
hs	何似
hs	呵手
hs	和誰
hs	嗐聲
hs	嚆矢
hsbd	戶樞不蠹
hsbrss	換生不如守熟
hsbx	戶樞不朽
hscx	虎兕出柙
hsd	華盛頓
hsdglbytq	華盛頓哥倫比亞特區
hsdhy	華盛頓會議
hsdj	嗐聲跺腳
hsdq	咳聲打氣
hsdq	好事多慳
hsds	海上都市
hsdw	猢猻大王
hsgx	會審公廨
hshlz	海上花列傳
hsj	含漱劑
hsj	浣紗記
hsl	換手率
hslq	齁聲雷起
hsls	好善樂施
hsls	好施樂善
hsm	哈士蟆
hspf	撼樹蚍蜉
hsq	黃水茄
hstd	海蝕臺地
hstq	咳聲歎氣
hstq	嗐聲歎氣
hstq	好事天慳
hstx	咳聲嘆息
hsw	海參崴
hswc	惠施五車
hswe	好善惡惡
hswj	惠施五車
hsws	好生惡殺
hswz	韓詩外傳
hsx	浣紗溪
hsx	胡三省
hsxx	函授學校
hsy	喉塞音
hsyq	和聲樂器
hsz	護士長
hszd	活似真的
hszq	花式撞球
hszy	禍生肘腋
hszz	畫蛇着足
ht	合沓
ht	和調
ht	寒蜩
ht	搳脫
ht	旱獺
htad	昏天暗地
htcd	熯天熾地
htcn	回頭掣腦
htdd	嚎天動地
hthd	嚎天喊地
hthd	昏天黑地
hthd	胡天胡地
hthd	號天號地
hthl	華亭鶴唳
htjd	花天酒地
htjd	花天錦地
htkd	號天叩地
htkd	號天哭地
htkd	號天扣地
htlb	後臺老闆
htmd	黑天摸地
htp	虎頭埤
htpd	號天拍地
htqd	呼天搶地
htst	後天失調
htx	和闐縣
htx	洪洞縣
htxd	歡天喜地
hty	和闐玉
hty	和闐語
htyb	虎體鵷班
htzd	撼天震地
htzs	華佗再世
hw	呵衛
hw	好惡
hw	扞衛
hw	縠紋
hw	華膴
hwbl	紅尾伯勞
hwcs	行伍出身
hwdnz	漢武帝內傳
hwhs	還我河山
hwj	好望角
hwjz	和丸教子
hx	㟏岈
hx	何遜
hx	劾繫
hx	化纖
hx	卉翕
hxaqs	航行安全書
hxb	壞血病
hxbd	橫行霸道
hxbf	嗑西北風
hxcs	鵠形菜色
hxd	滑行道
hxd	航行燈
hxd	華胥調
hxe	混血兒
hxgl	汗洽股慄
hxhy	活血化瘀
hxj	滑扢虀
hxjs	橫行介士
hxll	酣嬉淋漓
hxlz	胡行亂作
hxm	汗血馬
hxn	和稀泥
hxpr	含血噴人
hxq	紅血球
hxqscs	紅血球生成素
hxqx	魂消氣泄
hxrd	含笑入地
hxs	火星塞
hxt	還鄉團
hxtjzs	呼吸調節中樞
hxtx	橫行天下
hxwj	橫行無忌
hxwz	橫行文字
hxx	黑魆魆
hxxh	好行小惠
hxxh	好行小慧
hxxr	含血噀人
hxxw	化學纖維
hxy	頦下癭
hxyh	華夏銀行
hxyq	沆瀣一氣
hxyy	歡忻踊躍
hxyy	歡欣踊躍
hxyz	霍小玉傳
hxz	紅線傳
hxzz	橫行直撞
hy	佷用
hy	含蘊
hy	呵癢
hy	喉咽
hy	嗨喲
hyb	花葯瓣
hybm	紅顏薄命
hybz	行業標準
hyc	還原成
hycb	毀譽參半
hydz	海洋地質
hyer	禍盈惡稔
hyf	還原法
hyfb	還元返本
hyfy	還原反應
hyfz	行業發展
hygl	行業管理
hyj	還原劑
hyjh	含英咀華
hylt	虎咽狼吞
hylt	行業龍頭
hymb	紅顏命薄
hymc	荒煙蔓草
hyq	簧樂器
hyrg	會咽軟骨
hys	還有誰
hysm	還有什麼
hyst	婚姻失調
hysz	好語似珠
hywl	好逸惡勞
hywz	好諛惡直
hyxh	行業協會
hyy	行業語
hyy	還原焰
hyys	還以顏色
hyysjyfqz	華嚴一乘教義分齊章
hyz	很嚴重
hyzl	行業自律
hyzx	行業資訊
hyzy	還原作用
hz	何焯
hz	劾奏
hz	厚重
hz	合傳
hz	合從
hzbs	紇字不識
hzcq	黃鐘長棄
hzd	虎爪豆
hzey	涸澤而漁
hzfb	還珠返璧
hzgtlzr	含着骨頭露着肉
hzhj	後知後覺
hzhp	還珠合浦
hzj	花朝節
hzjq	麾之即去
hzk	酣中客
hzky	涸轍枯魚
hzl	胡遮刺
hzlb	畫脂鏤冰
hzll	嚇阻力量
hzlz	鬍子拉碴
hzpd	漢中盆地
hzq	虎爪拳
hzql	涸轍窮鱗
hzqrzs	還治其人之身
hzqy	涸轍窮魚
hzr	花朝日
hzsd	猴子似的
hztd	壺中天地
hzwd	毀舟爲杕
hzwj	悔之亡及
hzwszc	耗子尾上長瘡
hzy	很重要
hzym	還政於民
hzyx	漢藏語系
hzyx	花朝月夕
hzyy	花朝月夜
hzz	花柵子
hzzf	涸轍之鮒
hzzk	涸轍之枯
hzzp	糊仔栽培
hzzy	涸轍之魚
j	㑘
j	㑧
j	㑺
j	㒞
j	㒫
ja	湫隘
jabx	桀驁不遜
jacz	久安長治
jase	舊愛宿恩
jaxt	倨傲鮮腆
jb	俠拜
jb	儉薄
jb	剿捕
jb	勁兵
jb	勁拔
jbbq	肩膀不齊
jbcf	久別重逢
jbcx	居不重席
jbcy	居不重茵
jbd	吉布地
jbdd	腳不點地
jbdghg	吉布地共和國
jbdq	局部地區
jbfkll	基本放款利率
jbfx	矩步方行
jbgm	金榜掛名
jbh	鏡泊湖
jbj	加把勁
jbj	攪拌機
jbkg	揭不開鍋
jbl	嚼不了
jbl	建蔽率
jbl	蔣百里
jbl	進不了
jbnsj	噍吧哖事件
jbq	揭白旗
jbq	攪拌器
jbtm	金榜題名
jbyc	峻阪鹽車
jbyj	峻阪鹽車
jbyy	金波玉液
jbz	敬稟者
jbz	肩膀窄
jbz	見不着
jbz	見不長
jbz	金箔紙
jbzc	譾薄之材
jbzd	腳不沾地
jbzs	將兵長史
jc	久長
jc	九重
jc	交差
jc	僭稱
jc	兼差
jcb	揭瘡疤
jcbd	截長補短
jcbd	絕長補短
jcbh	金翅擘海
jcbl	攪纏不來
jcg	九重葛
jcg	嚼菜根
jcjd	絕長繼短
jcjz	緊差緊做
jcl	簡朝亮
jcld	家長裏短
jcls	交差了事
jcly	掎裳連襼
jclzj	芥川龍之介
jcs	夾彩塑
jcs	芥川賞
jcsf	幾次三番
jct	九重天
jct	芥菜頭
jcx	九重霄
jcxd	絕長續短
jcxx	警察學校
jcxz	基層行政
jcy	鑑藏印
jcyy	侷促一隅
jcyy	局促一隅
jcz	檢察長
jczh	據牀指麾
jczk	藉草枕塊
jd	九地
jd	井地
jd	京調
jd	京都
jd	借調
jdct	舊調重彈
jdcy	舊地重遊
jdd	吉玎玎
jddbl	叫地地不靈
jddfg	絕地大反攻
jdeqxz	見彈而求鴞炙
jdgd	吉丁疙疸
jdgd	咭噔咯噔
jdh	覺得很
jdhq	就地還錢
jdht	酒地花天
jdjkxzyb	基督教科學箴言報
jdjs	基地建設
jdjt	蹐地跼天
jdjx	簡單機械
jdk	角度看
jdl	舊大陸
jdlc	較短量長
jdmd	加德滿都
jdmf	車殆馬煩
jdmy	腳底抹油
jdp	卷地皮
jdp	揭底牌
jdqc	就地取材
jdqc	攪肚蛆腸
jdqh	極地氣候
jdqs	鶼鰈情深
jdqx	見彈求鴞
jdsecj	基度山恩仇記
jdsz	勁道十足
jdtt	絕地天通
jdx	接地線
jdx	江都縣
jdxl	精雕細鏤
jdy	校對員
jdyy	絕對音樂
jdz	見得着
jdzc	競短爭長
jdzf	就地正法
jdzj	覺得自己
jdznsz	腳打着腦杓子
je	勁兒
je	勦兒
je	沮遏
je	菁莪
je	謇諤
jebz	譎而不正
jepf	諫而剖腹
jerc	嫉惡如仇
jerc	嫉惡若仇
jerc	疾惡如仇
jerc	疾惡若仇
jeyddz	九二一大地震
jezf	謇諤之風
jezf	謇諤自負
jf	今番
jf	剿匪
jf	勁風
jf	嗟夫
jf	嗟憤
jfbs	澆風薄俗
jfc	菁芳草
jfhf	江翻海沸
jfj	幾番家
jfjc	疾風勁草
jfjs	剿撫兼施
jfjs	勦撫兼施
jfjz	局副局長
jfmj	覺返迷津
jfpz	剪髮披緇
jfs	傑弗遜
jfss	稷蜂社鼠
jfyl	金風玉露
jfzc	經費支絀
jfzjc	疾風知勁草
jfzm	葭莩之末
jfzq	葭莩之親
jg	九垓
jg	倨句
jg	叫聒
jg	嚼穀
jg	奸宄
jgbr	精貫白日
jgch	羯鼓催花
jgck	僅供參考
jgeq	揭竿而起
jgf	桔槔烽
jgfg	繼晷焚膏
jgfj	勁骨豐肌
jgfx	急管繁絃
jgl	莒光樓
jgld	莒光連隊
jgpy	價格便宜
jgss	金匱石室
jgtz	結構調整
jgxs	計功行賞
jgxx	警官學校
jgxx	軍官學校
jgyl	金匱要略
jgz	揭蓋子
jgz	泂蛤仔
jgz	濟公傳
jgzt	譎怪之談
jh	井幹
jh	井榦
jh	交行
jh	交還
jh	俊鶻
jhcw	湔浣腸胃
jhd	九還丹
jher	酒酣耳熱
jhfj	攪海翻江
jhg	交還給
jhg	寄還給
jhjxq	結婚進行曲
jhsc	矩矱繩尺
jhsz	接合生殖
jhwz	橘化爲枳
jhxd	江河行地
jhxj	近火先燋
jhxx	教會學校
jhyf	救火揚沸
jhyxf	集會遊行法
jhyxz	劫後英雄傳
jhzh	劍合珠還
jj	交角
jj	京畿
jj	倔強
jj	偈偈
jj	僥競
jjbc	借交報仇
jjbc	解劍拜仇
jjbl	解決不了
jjbnxw	緊急避難行爲
jjcj	積極參加
jjcl	捲甲重來
jjcx	角肩椿象
jjcy	積極參與
jjcz	經濟成長
jjczl	經濟成長率
jjd	聚集地
jjddz	集集大地震
jjdlx	經濟地理學
jjdx	踽踽獨行
jjex	踽踽而行
jjfyzmlz	急驚風遇着慢郎中
jjfzzmlz	急驚風撞着慢郎中
jjgc	經濟怪獸
jjgx	節儉躬行
jjhljjc	幾家歡樂幾家愁
jjhs	家給戶贍
jjj	咀嚼肌
jjj	將進酒
jjj	攪家精
jjj	殲擊機
jjjj	唧唧啾啾
jjjj	啾啾唧唧
jjl	京畿令
jjld	津津樂道
jjld	簡截了當
jjll	踽踽涼涼
jjlm	甲級流氓
jjls	燋金流石
jjlx	節儉力行
jjmz	家給民足
jjqc	鳩僭鵲巢
jjqd	蝍蛆鉗帶
jjqq	濟濟鏘鏘
jjqq	躋躋蹌蹌
jjrz	家給人足
jjsd	角巾私第
jjss	燋金爍石
jjwc	厥疾勿瘳
jjxj	舊家行徑
jjxs	見機行事
jjyw	家雞野鶩
jjyx	經濟運行
jjz	局局長
jjz	畸角子
jjzl	進酒作樂
jjzp	舉薦征辟
jjzs	掎角之勢
jjzs	犄角之勢
jjzy	舉酒作樂
jjzz	吉吉枓枓
jjzz	經濟增長
jk	揭開
jk	擊潰
jk	校勘
jk	機括
jk	檢括
jkb	藉寇兵
jkbc	借客報仇
jkcz	健康成長
jkgd	解開疙瘩
jkkl	健康快樂
jkl	吃口令
jks	傑克遜
jktf	進可替不
jktp	進可替否
jkx	校勘學
jl	伎倆
jl	假樂
jl	勁旅
jl	咎戾
jl	噍類
jlb	俱樂部
jlb	金蘭簿
jlbd	加里波的
jlbhpdfa	加勒比海盆地方案
jlbjse	疾雷不及塞耳
jlc	芥藍菜
jld	揭老底
jld	畸零地
jlf	家樂福
jlgd	膠萊谷地
jlh	金露花
jljs	經綸濟世
jll	伽利略
jll	加氯量
jll	角落裏
jll	觭龍類
jllc	迦羅林朝
jlmf	經綸滿腹
jlmk	金鏤梅科
jln	極樂鳥
jlpq	迦陵頻伽
jlpyy	菌類培養液
jlqn	酒醴麯櫱
jlqy	戢鱗潛翼
jls	嗟來食
jls	雞鹿塞
jlsj	極樂世界
jlsz	晶粒生長
jlw	儘落尾
jlwy	噍類無遺
jly	角礫岩
jlyb	機率預報
jlyy	金鏤玉衣
jlzm	攫戾執猛
jlzm	車笠之盟
jlzq	雞肋尊拳
jlzs	嗟來之食
jm	伽馬
jm	剿滅
jm	勦滅
jm	圈馬
jm	扃門
jmcw	舊夢重溫
jmd	金日磾
jmdz	雞毛撢子
jmh	姊妹行
jmhs	急脈緩受
jmls	鳩摩羅什
jmn	鏡面呢
jmpz	嚼墨噴紙
jmsw	糾繆繩違
jmsx	伽瑪射線
jmws	靜謐無聲
jmx	姊妹校
jmx	靜脈血
jmxsz	靜脈血栓症
jmy	角膜炎
jmy	雞瞀眼
jmyzs	角膜移植術
jmz	殲滅戰
jn	勁弩
jn	嬌娜
jn	嬌嫩
jn	攪惱
jn	期年
jndz	嘉南大圳
jnfz	桀逆放恣
jnsx	景寧畬鄉
jnszzzx	景寧畬族自治縣
jnwy	眷念無斁
jnyb	金奴銀婢
jnz	接捻子
jo	奇偶
jocm	金甌藏名
jp	僵仆
jp	揃平
jp	揭破
jp	擊扑
jp	解剖
jpfx	角平分線
jpgd	雞皮疙瘩
jpnr	嬌皮嫩肉
jpx	解剖學
jpy	揀便宜
jpy	撿便宜
jpyq	鍵盤樂器
jpz	柬埔寨
jpzmzg	柬埔寨民主國
jq	九芎
jq	僭竊
jq	勁秋
jq	喬怯
jq	嚼蛆
jqay	詰屈聱牙
jqfhs	雞棲鳳凰食
jqjs	駕輕就熟
jqjz	畸輕畸重
jqnx	交情乃見
jqp	攪蛆扒
jqsc	盡其所長
jqsj	兼權熟計
jqsx	矯情飾行
jqt	鮚埼亭
jqtl	盡情吐露
jr	奇日
jr	嬌嬈
jr	廄人
jr	戛然
jr	攪擾
jrbm	佳人薄命
jrbrzr	揀日不如撞日
jrbx	將銳兵驍
jres	計日而俟
jrez	戛然而止
jrhy	金融行業
jrkl	節日快樂
jrmb	佳人命薄
jrmb	肌肉麻痺
jrsth	間繞式彈簧
jrxw	捲入漩渦
jrz	窶人子
js	佳什
js	俠侍
js	借宿
js	假似
js	偈頌
jsb	家生婢
jsbg	經宿不歸
jsbmhxx	機事不密禍先行
jsbx	僭上偪下
jscs	技術參數
jscw	晉乘楚杌
jsd	角速度
jsd	賈似道
jsd	降升調
jsd	集散地
jsdy	酒食地獄
jsg	嚼舌根
jshh	借屍還魂
jsj	攪碎機
jsj	金三角
jsjd	軍事基地
jskb	尖酸刻薄
jsl	校書郎
jslj	結駟連騎
jsm	叫什麼
jsnc	雞尸牛從
jsnz	雞尸牛從
jsqx	精神缺陷
jsqz	芥拾青紫
jss	寄宿生
jst	嚼舌頭
jsth	擊碎唾壺
jswx	矯飾僞行
jsxd	濟時行道
jsxd	軍事行動
jsxl	及時行樂
jsxx	寄宿學校
jsxx	軍事學校
jsxz	借水行舟
jsy	爵士樂
jsyd	建設用地
jsyh	建設銀行
jsyh	舉扇一撝
jsyz	積善陰騭
jsz	給事中
jsz	近似值
jszc	九世之仇
jt	勁頭
jt	嗟嘆
jt	奇蹄
jt	奸慝
jt	姦慝
jtb	剪貼簿
jtbl	窘態畢露
jtc	金湯匙
jtcd	疾痛慘怛
jtcl	卷土重來
jtcl	捲土重來
jtd	驚天地
jtdd	驚天動地
jtgy	鈞天廣樂
jtjd	荊天棘地
jtjd	跼天蹐地
jtle	燋頭爛額
jtllx	腳踏兩來舡
jtm	奇蹄目
jtq	解調器
jtsd	腳踏實地
jtsj	鏡頭視角
jttd	集體土地
jtwd	經天緯地
jtxw	集體行爲
jty	鈞天樂
jtyh	交通銀行
jtys	交通壅塞
jtyx	劍頭一吷
jw	交惡
jw	僭妄
jw	勁舞
jw	徼外
jw	校尉
jwcj	金屋藏嬌
jwcz	積微成著
jwt	勁舞團
jwxj	井蛙醯雞
jwz	教務長
jwzs	雞鶩爭食
jwzw	家無長物
jwzy	極爲重要
jwzz	見微知著
jx	井宿
jx	健行
jx	僥倖
jx	僥傒
jx	僥幸
jxbg	夾心餅乾
jxbg	揪心扒肝
jxbj	軍需補給
jxbj	進行比較
jxbs	井渫不食
jxc	疥癬蟲
jxch	積薪厝火
jxd	繫鞋帶
jxdc	進行調查
jxdd	進行到底
jxe	畸形兒
jxex	接淅而行
jxfh	見血封喉
jxfr	績效斐然
jxfx	進行分析
jxfz	畸形發展
jxgq	節行瑰奇
jxgy	機械工業
jxgz	解弦更張
jxh	機械化
jxhbd	機械化部隊
jxhgz	機械化耕作
jxhj	縑緗黃卷
jxhm	鳩形鵠面
jxhy	機械行業
jxj	急行軍
jxjc	進行檢查
jxjl	進行交流
jxjy	進行交易
jxk	咀吸口
jxl	機械論
jxly	計行慮義
jxn	機械能
jxq	進行曲
jxqc	湔雪前恥
jxqm	進行全面
jxs	揭傒斯
jxs	機械手
jxs	雞血石
jxsjf	解析三角法
jxtn	經行吐衄
jxtx	抉瑕擿釁
jxtz	進行調整
jxw	繭纖維
jxw	肌纖維
jxwhb	緊行無好步
jxwsj	疾行無善跡
jxxg	進行修改
jxxl	機械效率
jxxp	稷下學派
jxxs	稷下先生
jxxz	教學相長
jxy	交響樂
jxy	機械油
jxyj	進行研究
jxyt	交響樂團
jxz	菌血症
jy	且月
jy	佳肴
jy	佳餚
jy	俊乂
jy	偈言
jyb	金銀箔
jybzf	簡易包紮法
jycq	集腋成裘
jyd	軍樂隊
jyfz	菁英分子
jygz	鋸牙鉤爪
jyjb	殲一警百
jyjh	咀英嚼華
jykj	決癰潰疽
jyl	就業率
jyll	姦淫擄掠
jyln	檻猿籠鳥
jyqb	戛玉敲冰
jyqj	戛玉敲金
jyqj	戛玉鏘金
jyr	嚼咬人
jys	九嶷山
jys	枸櫞酸
jys	金鑰匙
jysd	箭也似的
jysx	嘉言善行
jysx	謹言慎行
jywx	潔言污行
jywx	矯言僞行
jyxr	聚葯雄蕊
jyxw	經營行爲
jyxz	教育行政
jyy	角頁岩
jyyc	期月有成
jyyq	敬業樂羣
jyyx	嘉言懿行
jyyx	錦衣夜行
jyzj	就要扎腳
jyzx	覬覦之心
jyzz	覬覦之志
jz	交謫
jz	今朝
jz	借重
jz	偈子
jz	僭坐
jzb	精忠柏
jzbc	君子報仇
jzbs	尖嘴薄舌
jzc	角質層
jzd	居住地
jzd	雞爪釘
jzdc	藉箸代籌
jzdq	芥子毒氣
jzgd	建築工地
jzgldf	金紫光祿大夫
jzgz	咭吱咯吱
jzhz	揭債還債
jzjycrr	救之就要喫人肉
jzl	禁制令
jzll	基準利率
jzmd	齎志沒地
jznf	積重難返
jznxm	芥子納須彌
jzp	雞肫皮
jzqz	舉足輕重
jzrc	疾之如仇
jzrc	疾之若仇
jzrq	舉重若輕
jzsc	盡展所長
jzsc	經傳釋詞
jzsl	君子三樂
jzsyz	精忠說岳傳
jzt	紀傳體
jztml	蔣總統祕錄
jzts	膠柱調瑟
jztt	居中調停
jzwb	夾着尾巴
jzx	假執行
jzxs	箭在弦上
jzxw	聚酯纖維
jzxz	矜張顯著
jzy	句重音
jzy	芥子油
jzy	迦旃延
jzyhz	芥子園畫傳
jzyjjzz	今朝有酒今朝醉
jzz	卷軸裝
jzz	家長制
jzzc	近在咫尺
jzzl	急征重斂
jzzt	膠着狀態
k	㐄
k	㑌
k	㒑
k	㓂
k	㔞
ka	困隘
kb	刳剝
kb	刻薄
kb	揩背
kb	會弁
kb	檜柏
kbcj	潰不成軍
kbd	咖嗶丁
kbd	康白度
kbd	空包彈
kbdpd	科布多盆地
kbe	喀布爾
kbeh	喀布爾河
kbge	刻薄寡恩
kbl	開不了
kbyx	膾不厭細
kc	口仇
kc	口磣
kc	可磣
kc	吭哧
kc	咔嚓
kcbj	口才辨給
kcbx	口出不遜
kcd	開敞地
kch	扛長活
kcp	空藏瓶
kcpj	口齒便給
kcs	苦差事
kczx	可乘之隙
kd	哭調
kd	坎窞
kd	墾地
kd	揆度
kd	空地
kdq	跨地區
kds	空地稅
kdxq	抗毒血清
kdxx	克敦孝行
ke	困阨
ke	鏗爾
kebqsm	喀爾巴阡山脈
kekmg	喀爾喀蒙古
kekr	廓爾喀人
kewjp	喀爾文教派
kf	咖啡
kf	康阜
kf	愾憤
kf	括髮
kfd	咖啡店
kfg	咖啡館
kfj	咖啡鹼
kfpp	空腹便便
kfs	咖啡色
kft	咖啡廳
kfxs	看風行事
kfy	咖啡因
kfyh	開發銀行
kfz	咖啡座
kg	揩乾
kg	枯乾
kg	睽孤
kg	纊工
kgd	可耕地
kghnbkgal	可共患難不可共安樂
kglx	刻骨鏤心
kgsz	口乾舌燥
kh	刻鵠
kh	恐嚇
kh	括弧
kh	括號
kh	揩汗
khh	開戶行
khlw	刻鵠類鶩
khwd	愧惶無地
khx	恐嚇信
khx	恐嚇性
khx	苦寒行
khz	恐嚇罪
kj	傾家
kj	口勁
kj	口吃
kj	口給
kj	困覺
kjb	會計簿
kjb	會計部
kjbb	會計報表
kjcf	口角春風
kjcz	考績黜陟
kjf	會計法
kjhs	會計覈算
kjj	苦啾啾
kjjd	空軍基地
kjl	扣繳率
kjnd	會計年度
kjs	會計室
kjs	會計師
kjx	會計學
kjx	會計系
kjxq	抗菌血清
kjy	口角炎
kjzd	會計制度
kjzz	會計準則
kk	咳咳
kk	喀喀
kk	噲噲
kk	埳軻
kk	堀堁
kkkl	可口可樂
kkll	快快樂樂
kkqq	鏗鏗鏘鏘
kkzz	磕磕撞撞
kl	佝僂
kl	傀儡
kl	刻鏤
kl	可樂
kl	咖哩
klb	佝僂病
klbd	可了不得
klc	喀拉蚩
kld	刻鏤刀
kldy	克羅地亞
klf	咖哩粉
klf	咖哩飯
klhd	康樂活動
klj	咖哩雞
kljt	傀儡家庭
klkls	喀喇崑崙山
klly	夔龍禮樂
klnz	崑崙奴傳
kltz	克來汀症
klw	快樂丸
klx	傀儡戲
klz	咖哩汁
klzq	傀儡政權
klzy	快樂主義
km	刳木
km	匡謬
km	卡繆
km	可沒
km	揩抹
kml	喀麥隆
kmlghg	喀麥隆共和國
kmthz	跨媒體合作
kmyc	抗美援朝
kn	口訥
kn	愧恧
kn	括囊
kncc	困難重重
kngs	括囊拱手
knsl	括囊守祿
knsp	口能舌便
knx	康乃馨
knxj	抗凝血劑
kp	夸毗
kp	摳扒
kq	吭氣
kq	空弮
kq	肯綮
kq	鏗鏘
kqdl	揆情度理
kqky	口腔潰瘍
kqq	空氣鎗
kqsk	空前盛況
kqtj	空氣調節
kqtjj	空氣調節機
kqwc	孔雀王朝
kqzc	空氣軸承
kr	劻勷
kr	愒日
kr	鏗然
krcj	曠日長久
krcs	溘然長逝
krxs	看人行事
krxx	叩人心弦
krxx	扣人心弦
ks	吭聲
ks	咳嗽
ks	喀什
ks	款塞
ks	潰散
ksbl	可少不了
kscx	空水澄鮮
ksdx	炕上地下
ksge	喀什噶爾
kskt	克什克騰
ksm	可什麼
ksm	看什麼
ksm	開什麼
ksme	喀什米爾
ksrx	口尚乳臭
kstdx	喀斯特地形
ksx	可塑性
kszz	快速增長
kt	倥侗
kt	刊薙
kt	刳剔
kt	可調
kt	咳唾
ktcz	咳唾成珠
ktcz	欬唾成珠
ktj	空調機
ktjz	愷悌君子
ktjz	豈弟君子
ktmd	揩檯抹凳
ktpd	開天闢地
kts	崆峒山
ktsb	空調設備
ktsx	開堂歃血
ktwx	空調維修
ktz	空調症
ktzn	磕頭撞腦
kw	可惡
kw	噲伍
kw	潰圍
kw	睽違
kw	瞰亡
kwl	空屋率
kwxw	礦物纖維
kx	刊行
kx	刻削
kx	可行
kx	咯血
kx	咳血
kxc	開小差
kxdx	虧心短行
kxgy	苦心孤詣
kxly	空弦落雁
kxq	抗血清
kxwg	口血未乾
kxx	可行性
kxzy	抗頡作用
ky	凱樂
ky	愷樂
ky	昆邪
ky	混夷
ky	潰瘍
kyhc	枯魚涸轍
kyhz	枯魚涸轍
kyyx	潰於蟻穴
kz	刻著
kz	口重
kz	坤軸
kz	墾殖
kz	客長
kzcg	口燥脣乾
kzmx	困知勉行
kzrk	膾炙人口
kzx	可執行
kzxx	空中學校
kzz	矻睜睜
kzzl	苦中作樂
l	〇
l	㐬
l	㐭
l	㑍
l	㑝
la	了案
la	亮陰
la	老媼
la	諒陰
lb	了畢
lb	兩榜
lb	勒斃
lb	履薄
lb	廉白
lba	冷鼻凹
lbb	落褒貶
lbb	鋁箔包
lbc	了不成
lbcb	利弊參半
lbcmz	老蚌出明珠
lbcs	力薄才疏
lbd	了不得
lbd	老伯呆
lbd	落不的
lbdx	鏤冰雕朽
lbg	蘿蔔乾
lbh	老本行
lbjq	捋臂將拳
lbkj	樂不可極
lbky	樂不可言
lbkz	樂不可支
lbl	拉伯蘭
lbl	離不了
lbls	履薄臨深
lbn	老闆娘
lbn	黎巴嫩
lbnghg	黎巴嫩共和國
lbq	了不起
lbq	陸半球
lbs	落不是
lbs	落白事
lbslddf	魯般手裏調大斧
lbss	樂不思蜀
lbsz	老蚌生珠
lbt	羅伯特
lbxq	捋臂揎拳
lby	李伯陽
lby	淋巴液
lbyh	禮崩樂壞
lbz	鋁箔裝
lc	亂顫
lc	六朝
lc	六畜
lc	冷藏
lc	力畜
lcba	六畜不安
lcbj	樂此不倦
lcbp	樂此不疲
lcbx	令出必行
lcc	冷藏船
lcc	冷藏車
lcc	李長春
lcch	蓼菜成行
lcck	冷藏倉庫
lccs	了此殘生
lccw	鏤彩摛文
lccy	鏤塵吹影
lccz	老成持重
lcdx	立喫地陷
lcedt	拉長耳朵聽
lcf	冷藏法
lcfpj	樂昌分破鏡
lcg	羅剎國
lcgw	鹿車共挽
lcgx	裂裳裹膝
lcgz	裂裳裹足
lch	李昌鎬
lcj	來參加
lcj	冷藏間
lcjf	六朝金粉
lck	冷藏庫
lcl	拉長臉
lclhlwb	露出了狐狸尾巴
lcmj	露出馬腳
lcn	羅剎女
lcpj	樂昌破鏡
lcpt	狼喫幞頭
lcpz	露出破綻
lcq	兩重親
lcrg	兩重人格
lcs	冷藏室
lcs	老畜生
lcsf	兩次三番
lcsf	屢次三番
lcsf	累次三番
lcsg	凌遲碎剮
lcsz	潦草塞責
lct	拉抽屜
lcw	梁朝偉
lcwx	令出惟行
lcwz	老成穩重
lcx	拉長線
lcxj	六朝寫經
lcxx	糧草先行
lcyfb	樂處又逢悲
lcyj	露才揚己
lcz	列車長
lcz	落翅仔
lczf	六朝脂粉
ld	了得
ld	了斷
ld	了當
ld	了鳥
ld	兩地
ldb	撂地幫
ldb	落地幫
ldbd	了當不得
ldbhjdjcz	漏電保護接地極插座
ldbl	流動比率
ldbs	遼東白豕
ldc	落地窗
ldcf	立地成佛
ldct	老調重彈
ldcy	列鼎重裀
ldf	兩都賦
ldf	老地方
ldgc	掠地攻城
ldgc	略地攻城
ldh	藍點頦
ldhy	壟斷行業
ldjg	立地金剛
ldl	了得了
ldl	冷地裏
ldll	臉都綠了
ldm	陸德明
ldmzyy	拉丁美洲音樂
ldp	婁東派
ldp	榴彈炮
ldpg	瀝膽披肝
ldpg	露膽披肝
ldqc	略地侵城
ldqk	浪蕩乾坤
ldqz	落地簽證
lds	落地扇
lds	露兜樹
ldsc	立地書廚
ldse	兩豆塞耳
ldsg	落地生根
ldsx	陸地神仙
ldtlsp	冷凍調理食品
ldxj	氯丁橡膠
ldxm	立盹行眠
ldxx	類地行星
ldy	老都爺
ldy	菉豆眼
ldz	柳盜跖
ldz	老道長
ldz	落地罩
ldz	騾馱子
ldzx	撩東劄西
ldzx	撩東撾西
le	綠耳
le	蓼莪
lebh	樂而不荒
leby	樂而不淫
lesd	隆恩盛德
lewf	樂而忘返
lewg	樂而忘歸
lewy	樂而忘憂
lf	婁妃
lf	樂風
lf	氯仿
lf	泠風
lf	瀧夫
lfcj	漏脯充饑
lfcz	撩蜂喫螫
lfe	拉斐爾
lfm	露鋒芒
lfs	露風聲
lfsz	輪番上陣
lfts	理番通事
lfy	陸法言
lfyb	禮廢樂崩
lfyy	臨風搖曳
lg	兩丱
lg	晾乾
lg	樂國
lg	樂觀
lg	樂購
lgb	捋胳膊
lgb	錄鬼簿
lgc	良弓藏
lgcd	淚乾腸斷
lgd	老疙瘩
lgjbkzz	兩個肩膀扛張嘴
lgjj	肋骨舉肌
lgjq	樂觀進取
lgm	陸龜蒙
lgmj	鏤骨銘肌
lgmx	鏤骨銘心
lgncx	顱蓋內出血
lgqc	樂觀其成
lgs	撂過手
lgscrx	良賈深藏若虛
lgxf	論功行封
lgxs	論功行賞
lgzy	樂觀主義
lh	了話
lh	兩行
lh	六翮
lh	婪酣
lh	嫏嬛
lha	氯化銨
lhb	羅漢柏
lhb	龍虎榜
lhcm	聯合參謀
lhd	陸皓東
lhdc	雷轟電掣
lhfd	嫏嬛福地
lhg	氯化鈣
lhgc	烈火乾柴
lhgd	隆河谷地
lhgj	狼嗥鬼叫
lhh	冷呵呵
lhh	怔呵呵
lhh	樂呵呵
lhj	氯化鉀
lhj	瑯嬛記
lhj	老行家
lhj	陸鴻漸
lhl	蓮花樂
lhl	蓮花落
lhl	離婚率
lhm	氯化鎂
lhm	癩蝦蟆
lhmxcter	癩蝦蟆想喫天鵝肉
lhn	氯化鈉
lhpj	陸海潘江
lhq	氯化氫
lhslcbyb	老虎生了翅膀一般
lhszz	老和尚撞鐘
lhtz	鸞鵠停峙
lhw	氯化物
lhw	老行伍
lhx	捋虎鬚
lhx	氯化鋅
lhxdf	氯化消毒法
lhxz	樂禍幸災
lhy	拉祜語
lhy	氯化銀
lhyb	禮壞樂崩
lhyq	禮壞樂缺
lhz	拉祜族
lhz	老行尊
lj	㥄遽
lj	了局
lj	了決
lj	了結
lj	了解
ljb	冷肩膀
ljb	溜肩膀
ljbehdw	魯酒薄而邯鄲圍
ljbl	樂極悲來
ljbs	樂極悲生
ljc	鹿角菜
ljcc	鏤金錯采
ljcx	亂箭攢心
ljd	牢角底
ljdz	鏈接地址
ljfj	陸賈分金
ljfj	麟角鳳距
ljfm	麟角鳳毛
ljfz	麟角鳳觜
ljgw	鹿車共挽
ljh	鹿角畫
ljhz	裏急後重
ljj	肋間肌
ljj	邏輯閘
ljj	陸軍節
ljj	露脊鯨
ljjgxx	陸軍軍官學校
ljkd	勒緊褲帶
ljl	陸九齡
ljm	林覺民
ljmzjt	菱角磨作雞頭
ljp	潦漿泡
ljq	量角器
ljqk	了解情況
ljsb	樂極生悲
ljsl	累進稅率
ljst	亂嚼舌頭
ljww	梨頰微渦
ljwx	樂極忘形
ljx	六角形
ljx	老將行
ljxt	鱗鋏星鐔
ljy	陸九淵
ljz	陸家嘴
ljzb	樂極則悲
ljzy	邏輯重音
ljzz	劣跡昭著
ljzz	臨江折軸
lk	勒掯
lk	撂開
lk	李悝
lk	礧磈
lk	籠括
lkf	露口風
lkjj	利口捷給
lkkyy	洛可可音樂
lks	撂開手
lktd	林口臺地
lkzyjx	拉口子要見血
ll	了了
ll	了亮
ll	了劣
ll	了落
ll	僂儸
llb	利樂包
llb	聯絡簿
llbb	陸離斑駁
llc	流露出
llcc	潦潦草草
lldg	離了靛缸
lldz	犖犖大者
llex	量力而行
llfx	雷厲風行
llgg	陸離光怪
llgj	伶俐乖覺
lljj	趔趔趄趄
llld	勒里勒得
lllt	邋裏邋遢
llmm	琳瑯滿目
llq	盧棱伽
llqm	來龍去脈
llqq	趔趔趄趄
llqq	踉踉蹌蹌
llqq	踉踉蹡蹡
llr	飀飀然
lltt	樂樂陶陶
llxx	陸陸續續
llz	林樂知
llzc	利率政策
llzm	離婁之明
lm	來牟
lm	剌謬
lm	林杪
lm	流氓
lm	淪沒
lmbc	龍門刨牀
lmj	露馬腳
lmjbyex	良馬見鞭影而行
lmk	老門檻
lmll	粒米狼戾
lmlz	拉名糧長
lmm	老嬤嬤
lmpt	露面拋頭
lmrj	流氓軟件
lms	氯黴素
lmth	六脈調和
lmxx	類木行星
lmy	肋膜炎
lmyp	浪漫樂派
lmzh	兩面轉圜
ln	了納
ln	氂牛
ln	犛牛
ln	耒耨
ln	臉嫩
lnbs	臨難不懾
lnbz	臨難不懾
lnjy	籠鳥檻猿
lnws	臨難無懾
lnwz	臨難無懾
lnz	列女傳
lnz	烈女傳
lnzj	耒耨之教
lnzl	耒耨之利
lnzz	冷煖自知
lp	力拚
lp	拉胚
lp	撂皮
lp	樂普
lp	潦泡
lpb	臉皮薄
lpcq	攬轡澄清
lpfb	鸞飄鳳泊
lpff	洛浦宓妃
lpgj	樂貧甘賤
lplq	屢仆屢起
lprl	淚盤如露
lpsz	裂片生殖
lpxj	另闢蹊徑
lpy	落便宜
lq	了卻
lq	了清
lq	了訖
lq	兩棲
lq	戾氣
lqbd	兩棲部隊
lqbf	郎潛白髮
lqj	楞伽經
lql	錄取率
lqldw	兩棲類動物
lqryz	禮輕人意重
lqt	臘鎗頭
lqt	鑞鎗頭
lqyb	輪鎗拽步
lqyy	兩棲演員
lqyz	禮輕意重
lqzd	氯氣中毒
lqzmeq	良禽擇木而棲
lqzz	兩棲作戰
lr	了然
lr	倆人
lr	僂人
lr	泠然
lr	落忍
lrbh	了然不惑
lrfc	來日方長
lrjlb	老人俱樂部
lrl	利潤率
lrls	擄人勒贖
lrlsz	擄人勒贖罪
lrpj	爛若披錦
lrqq	領如蝤蠐
lrr	樂融融
lrsz	兩日三朝
lrx	麗人行
lrzc	來日正長
lrzz	了如指掌
lrzz	利潤增長
ls	㲯毿
ls	㶟水
ls	䍡𦌊
ls	䰐鬖
ls	了事
lsac	瞵視昂藏
lsb	梁山伯
lsb	烙燒餅
lsbc	略施薄懲
lsbj	樂善不倦
lsbq	斂聲屏氣
lsbz	流水簿子
lsbzyt	梁山伯祝英臺
lscy	歷史重演
lsd	亮色調
lsd	六十調
lsd	婁師德
lsd	朗誦調
lsdl	量時度力
lsdm	了身達命
lsdsb	羅塞達石碑
lsf	拉塞福
lsfc	露宿風餐
lsfq	露水夫妻
lsgh	老死溝壑
lsgz	勞什骨子
lsh	了事環
lshs	樂善好施
lshy	樂善好義
lsjd	露水交道
lsjj	驢生戟角
lsjj	驢生笄角
lsjs	亂三攪四
lsjs	氯絲菌素
lsjxq	雷神進行曲
lsl	零稅率
lslb	臨深履薄
lssr	老師宿儒
lsss	鹿死誰手
lst	羅塞提
lst	邏逤檀
lsws	戀生惡死
lsxd	孿生兄弟
lsxd	立身行道
lsxgcxs	雷射血管成形術
lsxj	立身行己
lsxrksb	路上行人口似碑
lsxx	綠色行銷
lsxy	流水行雲
lsy	呂宋菸
lsyj	硫酸菸鹼
lsyy	露水姻緣
lsyz	冷水養殖
lsz	僗什子
lsz	勞什子
lsz	孿生子
lsz	撈什子
lsz	柳氏傳
lszbzrms	冷手撾不着熱饅首
lszz	祿山之爪
lszz	老身長子
lt	亂彈
lt	儱侗
lt	六韜
lt	孌童
lt	戾天
ltam	樂天安命
ltb	邋遢本
ltbd	老天拔地
ltbj	落魄不羈
ltbz	兩頭不着
ltdb	雷霆電雹
ltdd	擂天倒地
ltdg	樂亭大鼓
ltdt	立體地圖
ltdy	露天電影
ltdz	露臺弟子
ltf	靈頭幡
lthl	龍韜虎略
lthy	狼吞虎咽
lthy	龍騰虎躍
lthz	鸞停鵠峙
ltj	露頭角
ltjc	露天劇場
ltk	露天礦
ltkfz	露天咖啡座
ltmd	良田美地
ltp	樂天派
ltpp	浪濤澎湃
ltpx	落湯螃蟹
ltsl	六韜三略
ltsp	六通四辟
ltt	樂陶陶
ltwg	陵土未乾
ltz	勞臺重
ltz	撂挑子
ltzm	樂天知命
lw	了悟
lw	了無
lw	梨渦
lw	樂網
lw	率爲
lwb	露尾巴
lwc	盧文弨
lwct	露尾藏頭
lwga	了無掛礙
lwga	了無罣礙
lwhj	了無痕跡
lwln	廉頑立懦
lwqg	了無牽掛
lwrz	力微任重
lwsj	了無生機
lwsq	了無生趣
lwss	略無參商
lwxy	了無新意
lwyebx	龍無雲而不行
lwz	李娃傳
lwzj	了無長進
lwzx	臨危自省
lwzx	陸王之學
lx	例行
lx	僂行
lx	冷血
lx	列宿
lx	力行
lxb	旅行包
lxb	流行病
lxb	練習簿
lxb	離心泵
lxbj	離鄉避井
lxbx	流行病學
lxc	旅行車
lxcc	流血成川
lxcg	漏泄春光
lxch	流血成河
lxcj	陸相沉積
lxcq	流血成渠
lxd	榴霰彈
lxdw	冷血動物
lxdx	力學篤行
lxf	陸秀夫
lxfs	流血浮尸
lxgq	流行歌曲
lxgs	例行公事
lxgx	狼心狗行
lxh	禮行貨
lxhb	龍行虎步
lxjc	履舄交錯
lxjt	旅行劇團
lxjy	厲行節約
lxjz	令行禁止
lxkg	鏤心刻骨
lxkmzcy	羅夏克墨漬測驗
lxkz	流行坎止
lxl	離心率
lxlh	流血流汗
lxll	撂下臉來
lxpc	流血漂杵
lxpl	流血漂鹵
lxq	六弦琴
lxq	淪陷區
lxql	流血千里
lxqs	流行趨勢
lxrls	令行如流水
lxs	旅行社
lxs	流行色
lxsz	兩性生殖
lxt	旅行團
lxtj	漏泄天機
lxwx	李下無蹊
lxx	樂嘻嘻
lxx	流行學
lxx	流行性
lxx	隴西行
lxx	龍涎香
lxxgm	流行性感冒
lxxq	捋袖揎拳
lxxq	擄袖揎拳
lxy	流行語
lxyc	略遜一籌
lxyy	流行音樂
lxz	拉弦子
lxz	旅行者
lxz	流涎症
lxz	流行症
lxzc	瀝血之仇
lxzp	旅行支票
lxzx	力行哲學
lxzz	履行職責
ly	了語
ly	了願
ly	仂語
ly	六樂
ly	六爻
lyaj	樂業安居
lyb	留言簿
lybbzd	立於不敗之地
lybcs	漏眼不藏絲
lybh	禮樂崩壞
lybz	露一鼻子
lycy	鏤月裁雲
lyd	留餘地
lyfm	龍躍鳳鳴
lyfy	綸音佛語
lyg	龍眼乾
lygb	冷軋鋼板
lygj	羚羊掛角
lyh	梨園行
lyh	陸緣海
lyhj	連營畫角
lyj	酈食其
lykl	良醞可戀
lyl	利用率
lylb	臨淵履薄
lypd	洛伊盆地
lyqlj	洛陽伽藍記
lys	摟衣裳
lys	琅邪山
lys	瑯琊山
lys	露一手
lysd	旅遊勝地
lysf	兩腋生風
lysz	聊以塞責
lytks	琅邪臺刻石
lytq	龍躍天衢
lywg	禮樂爲鉤
lywy	樂以忘憂
lyx	氯乙烯
lyx	露原形
lyxcjw	陸源性沉積物
lyxl	利用效率
lyxx	聾啞學校
lyxxcly	露營休閒車旅遊
lyy	樂遊原
lyyd	留有餘地
lyz	柳毅傳
lz	亂撞
lz	了債
lz	了帳
lz	了賬
lz	僂指
lzd	立足地
lzd	陸戰隊
lzg	樂子館
lzg	落子館
lzh	老在行
lzh	龍爪槐
lzj	裂殖菌
lzjc	裂眥嚼齒
lzjx	連朝接夕
lzjx	隆重舉行
lzl	靈長類
lzld	龍鍾潦倒
lzm	靈長目
lzq	劉長卿
lzq	聯軸器
lzqz	樂在其中
lzs	李宗盛
lzs	龍爪書
lzsb	龍藏寺碑
lzsl	陸讋水慄
lztc	隆重推出
lzwr	掠脂斡肉
lzx	閬中縣
lzxg	慮周行果
lzxs	履中行善
lzz	勞尊重
lzz	樂滋滋
lzzd	立足之地
lzzd	立錐之地
m	㐷
m	㑤
m	㑻
m	㒙
m	㒝
ma	謬愛
ma	魔媼
ma	麛夭
mawf	民安物阜
mb	卯簿
mb	名榜
mb	名簿
mb	命薄
mb	孟賁
mbbl	痲痹不了
mbbl	痲痺不了
mbbl	麻痹不了
mbbl	麻痺不了
mbbr	麻痺不仁
mbdd	忙不迭地
mbdm	鳴鞭電抹
mbdy	麻痹大意
mbdy	麻痺大意
mbj	馬鼻疽
mbjjz	名不見經傳
mbjs	目不給視
mbk	抹不開
mbks	悶不吭聲
mbl	免不了
mbl	馬伯六
mbl	馬伯樂
mbl	馬泊六
mbl	馬百六
mbld	明白了當
mbrh	命薄如花
mbs	沒不煞
mbs	莫泊桑
mbt	沒包彈
mbxj	目不暇給
mbxl	抹不下來
mbxq	命薄相窮
mbxx	名不虛行
mbyj	門不夜扃
mbyx	面薄腰纖
mbz	抹脖子
mbz	摸不着
mbzl	棉薄之力
mbzlc	馬不知臉長
mbztl	摸不着頭路
mbztn	摸不着頭腦
mbzy	抹不着影
mc	免參
mc	免黜
mc	埋藏
mc	娩出
mc	廟朝
mcbw	沒齒不忘
mcc	馬齒長
mcd	沒揣地
mcd	沒揣的
mcd	賣痴獃
mcdz	茅廁的磚
mch	澠池會
mchd	慢藏誨盜
mcjc	馬齒加長
mck	茅廁坑
mckc	目瞠口哆
mckwq	馬厝卡舞曲
mcldst	茅廁裏的石頭
mcnm	沒齒難泯
mcnw	沒齒難忘
mcpy	茅椽蓬牖
mcs	賣長舌
mctz	馬齒徒長
mcww	滿朝文武
mcx	澠池縣
mcx	馬齒莧
mcxs	謬採虛聲
mcyxl	名臣言行錄
mcz	沒出長
mczg	澠池之功
mczq	暮楚朝秦
mczs	滅此朝食
mczt	茅廁磚頭
md	冒頓
md	名都
md	墓地
md	墨絰
md	墨翟
mdb	木地板
mdd	目的地
mdd	馬燈調
mddf	冒鏑當鋒
mddt	密點地圖
mdfdlhtd	賣荳腐點了河灘地
mdfx	漫地風雪
mdh	毛地黃
mdhz	買櫝還珠
mdjj	滿地荊棘
mdjzm	滿地撿芝麻
mdkl	蒙地卡羅
mdl	沒地里
mdl	猛地裏
mdlxj	沒地裏巡檢
mdmt	昧地瞞天
mdmt	昧地謾天
mdmt	漫地漫天
mdn	麥地那
mdns	木雕泥塑
mdw	目的物
mdwx	明德惟馨
mdx	沒德行
mdx	目的性
mdy	祕雕魚
mdz	慢調子
me	抹額
me	謐爾
mebl	祕而不露
mebx	沒而不朽
mebx	祕而不宣
mebx	祕而不泄
mect	泯耳攢蹄
medf	馬爾地夫
medfghg	馬爾地夫共和國
meyn	賣兒鬻女
mf	抹腹
mf	祕府
mf	祕方
mf	祕法
mf	祕訪
mfcp	賣富差貧
mfcy	鳴鳳朝陽
mfjl	滿腹經綸
mfs	麻沸散
mfsz	抹粉施脂
mfyd	麋沸蟻動
mfyj	麋沸蟻聚
mg	哤聒
mg	沒官
mg	沒骨
mg	綿亙
mg	蜜柑
mgb	賣胳臂
mgc	霉乾菜
mgd	麪疙瘩
mgdf	蒙古地方
mgdf	蒙古大夫
mgh	沒骨畫
mghh	沒骨花卉
mghsjz	湄公河三角洲
mgj	沒乾淨
mgj	沒感覺
mgj	猛個勁
mglbdcj	美國聯邦調查局
mgmj	沒乾沒淨
mgsh	莫敢誰何
mgssj	麥格塞塞獎
mgy	藐姑射
mgyj	買官鬻爵
mgyj	賣官鬻爵
mgyq	木管樂器
mgyt	邁過隅頭
mgyy	賣官鬻獄
mgzy	暮虢朝虞
mh	抹黑
mh	杪忽
mh	每行
mh	毛蚶
mh	沒後
mhd	沒忽的
mhdzh	棉花店着火
mhj	驀忽間
mhjs	摩訶迦葉
mhjx	螞蝗見血
mhk	沒行款
mhl	磨喝樂
mhld	沒海履地
mhnr	民和年稔
mhq	閔行區
mhsl	眠花宿柳
mhxl	貌合行離
mj	卯勁
mj	名角
mj	嘿記
mj	墓碣
mj	懋績
mjcc	芒角撐腸
mjd	馬騎燈
mjdc	目擊道存
mjhc	蔓徑荒草
mjhl	夢覺黃粱
mjjnyy	馬偕紀念醫院
mjjw	摸金校尉
mjjy	美酒佳肴
mjlg	銘肌鏤骨
mjls	名韁利索
mjls	名韁利鎖
mjph	弭節徘徊
mjpzbzmjd	買金偏撞不着賣金的
mjt	沒嚼頭
mjwb	馬角烏白
mjxx	末節細行
mjyy	沒金飲羽
mjyy	馬偕醫院
mjyz	賣爵鬻子
mjz	摩羯座
mk	門檻
mkhb	名魁虎榜
mkn	馬褲呢
mktk	門檻條款
mkwf	民康物阜
ml	冪䍦
ml	夢露
ml	彌綸
ml	抹了
ml	抹淚
mlas	冒露安身
mlbc	綿力薄材
mlbs	名列榜首
mlcc	暮禮晨參
mld	沒了當
mldd	瑪莉都鐸
mldl	磨礱砥礪
mlh	命令行
mlj	麻六甲
mljc	沒了結處
mljhx	麻六甲海峽
mll	毛利率
mll	沒亂裏
mll	沒了落
mllml	瑪麗蓮夢露
mlmh	顢裏顢頇
mlml	沒撩沒亂
mlml	沒留沒亂
mlml	迷溜沒亂
mlml	迷留沒亂
mlmt	米釐米突
mlq	沒了期
mlr	蔓綠絨
mlrc	抹淚揉眵
mls	沒亂死
mls	沒亂殺
mls	沒亂煞
mlty	蜜裏調油
mlx	馬良行
mlxj	夢蘭叶吉
mlxx	賣弄玄虛
mlz	沒落子
mm	嚜嚜
mm	埋沒
mm	姏母
mm	嬤嬤
mm	宓穆
mmbl	悶悶不樂
mmbz	摸門不着
mmd	嬤嬤爹
mmdd	抹抹丟丟
mmdd	抹抹颩颩
mmdhx	眉毛都會笑
mmes	瞑目而逝
mmgg	罵罵括括
mmhh	悶悶渴渴
mmhq	脈脈含情
mmjc	祕密警察
mmjs	祕密結社
mmjx	謾罵叫囂
mmjy	祕密交易
mml	媽媽樂
mml	末末了
mml	面沒羅
mmll	名目利率
mmm	嬤嬤媽
mmn	末杪年
mmnx	瞑目寧心
mmrc	埋沒人才
mmsd	沒命似的
mmsh	祕密社會
mmss	木木樗樗
mmt	抹芒頭
mmtxzy	祕密通訊自由
mmwj	祕密外交
mmww	沒沒無聞
mmwy	嘿嘿無言
mmwy	嘿嘿無語
mmxa	滅門血案
mmxj	祕密選舉
mmxp	冒名行騙
mmxs	盲目行事
mmxx	乜乜屑屑
mmxx	乜乜踅踅
mmyq	膜鳴樂器
mmzr	祕密證人
mmzy	靡靡之樂
mmzz	暮暮朝朝
mmzz	莽莽撞撞
mn	木訥
mn	氂牛
mn	民埝
mn	沒溺
mn	牟尼
mnh	沒奈何
mnm	美耐皿
mnwy	木訥無言
mo	木禺
mosl	眠鷗宿鷺
mp	抹平
mp	抹片
mp	抹牌
mp	毛坯
mp	面皰
mpb	面皮薄
mpdt	螞蚍叮腿
mpdt	麻蚍叮腿
mpdz	抹牌道字
mpf	螞蚍蜉
mpsc	目披手抄
mpzj	滿拚自盡
mq	万俟
mq	懋遷
mq	抹去
mq	抹搶
mq	抹蹌
mqd	懋勤殿
mqe	宓契爾
mqly	眠琴綠陰
mqmz	沒輕沒重
mqrx	滿腔熱血
mqryd	明鎗容易躲
mqxj	賣俏行姦
mqyd	明鎗易躲
mqyz	賣妻鬻子
mqz	磨趄子
mqzl	暮去朝來
mr	嘿然
mr	尨茸
mr	懣然
mr	沒人
mr	沒入
mrbj	漠然不覺
mrhs	驀然回首
mrmb	美人命薄
mrpz	美人胚子
mrqx	浼人親行
mrrnb	罵人如奴婢
mrwj	懵然未覺
mrxx	面如噀血
mrzz	每日逐朝
mrzz	面如重棗
ms	名姝
ms	名宿
ms	抹上
ms	抹拭
ms	抹殺
msbl	冒霜撥露
msbs	面生不熟
msbw	沒世不忘
msbw	沒身不忘
msclg	苜蓿長欄干
mscs	眉似春山
mscx	模塑成形
msdk	茅塞頓開
msdq	目似點漆
msdz	茅廁的磚
msfw	苜蓿風味
msh	沒事哏
msh	沒是哏
msj	祕書監
msj	賣死勁
msjxq	馬賽進行曲
msk	茅廁坑
msldst	茅廁裏的石頭
mslj	捫參歷井
mslj	泌水樂飢
msm	沒什麼
msm	買什麼
msmx	目似明星
msmyj	沒什麼要緊
msn	木嗩吶
msns	繆思女神
msnw	沒世難忘
msr	驀生人
mss	摸手熟
mss	祕書省
mssy	漫山塞野
mst	密斯忒
mswk	孟什維克
msxg	瞞神諕鬼
msy	木芍藥
msyh	民生銀行
msyw	沒死以聞
msyy	民俗音樂
msz	祕書長
msz	麼些族
mszb	門衰祚薄
mszs	暮四朝三
mszt	茅廁磚頭
mszw	蔓生植物
mt	抹撻
mt	抹貼
mt	抹頭
mt	祕探
mt	緬靦
mtb	沒彈剝
mtbz	摸頭不着
mtcd	漫天徹地
mtch	抹土搽灰
mtcx	馬頭草檄
mtd	沒頭蹲
mtd	馬頭調
mtdc	命途多舛
mtgd	彌天亙地
mtgd	漫天蓋地
mthd	眉貼花鈿
mthy	煤炭行業
mtj	沒調教
mtjd	寞天寂地
mtlbz	摸頭路不着
mtmd	漫天漫地
mtmd	瞞天昧地
mtmd	謾天昧地
mtmd	謾天謾地
mtmn	沒頭沒腦
mts	沒撻煞
mtsd	木頭似的
mtsd	漫天塞地
mtwr	腼腆溫柔
mtxd	幕天席地
mtxd	瞞天席地
mtyd	埋天怨地
mtysetyd	莫蹪於山而蹪於垤
mtz	磨佗子
mtz	磨它子
mtzd	漫天匝地
mtzz	穆天子傳
mw	媚嫵
mw	祕聞
mw	謬妄
mw	謬誤
mwbc	謬誤百出
mwdb	名微德薄
mwl	蒙霧露
mwmd	漫無目的
mwml	沒完沒了
mwxs	面無血色
mwzz	目無尊長
mx	冥行
mx	娩息
mx	媚行
mx	懋勛
mx	抹胸
mxfb	命小福薄
mxfx	捫隙發罅
mxj	抹香鯨
mxl	抹下臉
mxlg	銘心鏤骨
mxn	抹稀泥
mxsh	目下十行
mxsl	謀泄事露
mxt	祕戲圖
mxtz	冥行擿埴
mxw	棉纖維
mxwf	民熙物阜
mxxg	毛細血管
mxz	夢行症
mxz	沒行止
mxzs	暮想朝思
my	埋冤
my	埋怨
my	模樣
my	氂纓
my	民樂
mybzh	抹一鼻子灰
mycf	民殷財阜
myd	莫邪鈍
mydc	民意調查
myft	民怨沸騰
mygj	沒有感覺
mygy	鰵魚肝油
myl	沐浴露
mync	牧養納畜
mypf	抹月批風
mypf	抹月披風
mypx	毛義捧檄
myql	繆以千里
myql	謬以千里
myr	賣妖嬈
mysc	卯酉參辰
mysd	名譽掃地
mysm	沒有什麼
mysmdl	沒有什麼道理
mytx	馬躍檀溪
myxq	免疫血清
myxz	名譽校長
myz	抹油嘴
myzs	謬悠之說
myzy	暮雨朝雲
myzymjwlgb	沒有長羽毛就忘了根本
mz	冒撞
mz	名著
mz	弭棹
mz	抹嘴
mz	抹子
mzc	抹嘴喫
mzdq	民族地區
mzj	沒長進
mzjy	美饌佳餚
mzl	命中率
mzl	沒着落
mzl	瞑子裏
mzl	賣查梨
mzlc	繆種流傳
mzlc	謬種流傳
mzmc	莽榛蔓草
mzml	沒查沒利
mzml	沒着沒落
mzmr	每朝每日
mzq	閔子騫
mzs	麼子事
mzsb	明珠生蚌
mzsdcs	面子上的差使
mzt	沒賺頭
mzt	莫扎特
mztq	明珠彈雀
mzts	名重太山
mzwyh	蒙藏委員會
mzx	沒志行
mzxb	猛着先鞭
mzy	沒長眼
mzyd	民族樂隊
mzyq	民族樂器
mzyy	民族音樂
mzz	賣豬仔
mzzb	猛着祖鞭
mzzr	每朝逐日
n	㐡
n	㐻
n	㑎
n	㑚
n	㒟
na	嬭媼
nb	女婢
nb	奴婢
nb	年伯
nb	捻鼻
nb	撓北
nbc	南北朝
nbdc	怒臂當車
nbdf	南部地方
nbdj	怒臂當車
nbe	尼泊爾
nbewg	尼泊爾王國
nbkw	南北睽違
nbl	拿不了
nbtz	齧蘗吞針
nby	粘板岩
nc	內參
nc	內朝
nc	南朝
nc	南琛
nc	奴儕
ncbs	奴脣婢舌
ncc	內長城
ncc	嫩綽綽
ncdq	農村地區
ncj	內錯角
ncsy	難償所願
ncwd	你長我短
ncx	內出血
ncx	腦出血
ncxx	拿粗挾細
ncyy	霓裳羽衣
ncyyq	霓裳羽衣曲
ncyyw	霓裳羽衣舞
nd	內地
nd	內調
nd	凝睇
nd	南都
nd	恁地
ndch	農地重劃
ndgg	農地改革
ndm	橈動脈
nds	內地稅
ndzj	內地雜居
ndzr	難當重任
nelx	逆耳利行
neylbqt	男兒有淚不輕彈
nf	懦夫
nf	捻匪
nf	捻泛
nf	煖房
nftz	弄粉調朱
ng	囊括
ng	女紅
ng	惱聒
ng	搦管
ng	擰乾
ngcg	搦管操觚
ngcw	納垢藏污
ngdf	哪個地方
ngdf	那個地方
ngg	鬧垓垓
ngt	嫩骨頭
nh	吶喊
nh	嫩寒
nh	嫩黃
nh	捻合
nh	搦翰
nhh	暖和和
nhkmd	內行看門道
nhnp	男婚女聘
nhr	內行人
nhrc	粘花惹草
nhrx	粘花惹絮
nj	內姊
nj	內角
nj	女給
nj	女角
nj	嫩江
njb	嫩肩膀
njbd	南箕北斗
njbz	南橘北枳
njdd	躡蹻擔簦
njdl	南極大陸
njdq	南極地區
njgc	鳥盡弓藏
njgs	牛角掛書
njj	牛角尖
njl	農家樂
njlx	弩箭離絃
njns	捻腳捻手
njq	內角球
njs	女校書
njs	嫩江省
njss	牛角書生
njw	女校尉
njyk	鳥驚魚潰
njzg	牛角之歌
njzz	年均增長
nk	兒寬
nk	囊括
nk	拏空
nk	攮糠
nk	訥口
nkl	你快樂
nktsz	南柯太守傳
nl	內陸
nl	呢料
nl	嫩涼
nl	嫩綠
nl	嫩臉
nlg	內陸國
nlh	內陸海
nlh	內陸湖
nll	年利率
nlyqs	蔦蘿施喬松
nlyx	南樓詠謔
nlz	女落子
nm	南無
nm	嫩苗
nm	寧謐
nm	恁麼
nm	淖糜
nmbc	南面百城
nmcb	南面稱伯
nmcm	怒目攢眉
nmd	牛眠地
nmdz	濃抹淡妝
nmf	南無佛
nmhx	鳥面鵠形
nmjs	南蠻鴃舌
nmjt	匿名揭帖
nmm	奶嬤嬤
nmw	瘧媒蚊
nmy	南無耶
nmz	那麼着
nn	吶吶
nn	呢喃
nn	呶呶
nn	娜娜
nn	嫋娜
nnbx	呶呶不休
nncc	呢呢痴痴
nnfl	嬝娜風流
nnnn	喃喃吶吶
nnnn	嫋嫋娜娜
nnnn	嬝嬝娜娜
nnnn	忸忸怩怩
nnrr	囁囁嚅嚅
nnxq	嬝娜纖巧
nnxy	呢喃細語
nnyy	扭扭屹屹
nnz	呶呶嘴
nnzj	男女主角
nnzt	忸怩作態
no	你哦
np	弄甏
np	泥坯
np	納聘
npdg	粘皮帶骨
npj	男配角
npx	牛皮癬
npx	腦貧血
npz	奶膀子
npzg	粘皮着骨
nq	嫩晴
nq	攮氣
nq	溺器
nqbd	南腔北調
nqd	弄腔調
nqk	弄乾坤
nqkj	甯戚扣角
nqnd	拿腔拿調
nqpz	拈輕怕重
nqqs	年輕氣盛
nr	呢絨
nr	囁嚅
nr	嶷然
nr	恧然
nr	懦弱
nrtj	惄如調饑
ns	內省
ns	嫩手
ns	恧縮
ns	挼挲
ns	捏塑
nsbd	南水北調
nsbnx	能說不能行
nscm	寧塞城門
nsd	暖色調
nsh	那時候
nsm	拿什麼
nsmd	泥塑木雕
nsng	捻神捻鬼
nsnj	捻手捻腳
nsnj	躡手躡腳
nsqs	年少氣盛
nss	腦栓塞
nsss	女生宿舍
nsx	鳥獸行
nsxz	逆水行舟
nsyk	鳥散魚潰
nsz	腦杓子
nszg	泥塞竹管
nszz	牛山濯濯
nt	內帑
nt	粘土
nt	粘帖
nt	那天
nt	那臺
ntbd	南天北地
ntflq	內填琺瑯器
ntph	怒濤排壑
nw	南無
nw	女媧
nw	瘧蚊
nw	那位
nwbt	女媧補天
nwz	溺窩子
nx	內省
nx	凝霰
nx	南絃
nx	南行
nx	女宿
nxbj	內省不疚
nxdd	黏涎答答
nxdf	哪些地方
nxds	逆行倒施
nxe	寧馨兒
nxf	內省法
nxg	拗相公
nxgss	腦血管栓塞
nxhd	穠纖合度
nxmb	腦性麻痺
nxtd	牛餼退敵
nxxx	凝血現象
nxyz	凝血因子
nxz	膿血債
nxz	黏涎子
nxza	凝血障礙
ny	內蘊
ny	凝咽
ny	南樂
ny	呢衣
ny	女樂
nybc	南轅北轍
nybl	奴顏婢睞
nybs	煖衣飽食
nybx	奴顏婢膝
nybz	南轅北轍
nyc	瘧原蟲
nycx	匿影藏形
nydy	年湮代遠
nyjs	拏雲攫石
nyjxh	農業機械化
nylz	能牙利爪
nysj	尿液篩檢
nytf	弄月摶風
nyx	腦溢血
nyyh	農業銀行
nyzf	躡影追風
nyzf	躡景追飛
nz	內傳
nz	凝重
nz	努着
nz	呢子
nz	哪吒
nzb	牛仔布
nzbz	捻着鼻子
nzczzy	女子參政主義
nzdm	濃妝淡抹
nzfe	躡足附耳
nzgj	那種感覺
nzj	黏着劑
nzjzyx	寧撞金鐘一下
nzl	年增率
nzl	黏着力
nzqk	扭轉乾坤
nzqz	躡足潛蹤
nzs	腦中樞
nzsm	能做什麼
nzx	黏着性
nzxj	女長須嫁
nzym	濃妝豔抹
nzz	牛仔裝
nzz	腦鑿子
o	ㄛ
o	ㄡ
o	㒖
o	㭝
o	㰶
ob	鷗波
og	區蓋
oh	哦呵
oh	喔嚄
ol	歐陸
ol	甌窶
oo	哦哦
oo	喔喔
ooo	哦哦哦
op	藕披
ot	區脫
oy	哦呀
oy	哦喲
oy	喔呀
oy	喔唷
oy	喔喲
oydl	歐亞大陸
p	㐴
p	㒒
p	㓟
p	㓲
p	㓻
pa	便安
pa	迫隘
pb	丕變
pb	便嬖
pb	傍薄
pb	傍邊
pb	剖別
pbl	潑包婁
pbl	跑不了
pbl	騙不了
pbqz	剖蚌求珠
pbxx	炮兵學校
pbyc	噴薄欲出
pbzc	朋比作仇
pc	僕從
pc	啪嚓
pc	嘌唱
pc	嬪從
pc	扒城
pcbj	片長薄技
pccl	攀車拒輪
pcg	盆成括
pcg	盤成括
pcjgb	裴岑紀功碑
pck	盆成括
pck	盤成括
pcmj	片長末技
pcpd	怕長怕短
pcw	蟠螭紋
pcwz	攀車臥轍
pcxw	偏差行爲
pcyx	賠償醫學
pd	㕷噠
pd	仆地
pd	僻地
pd	剖斷
pd	否德
pdbl	平地波瀾
pdct	盤底朝天
pdd	撲搭地
pdfb	平地風波
pdgl	劈地價來
pdkt	闢地開天
pdlt	平地樓臺
pdnsm	帕德嫩神廟
pdqfb	平地起風波
pdqgd	平地起孤丁
pdqgd	平地起孤堆
pdqy	平地青雲
pdr	屁鳥人
pdsb	平地山胞
pdsl	平地松林
pdsqygpl	平地上起一個霹靂
pdxqj	平地下鍬撅
pdysl	平地一聲雷
pe	偏阿
pe	辟咡
pech	辟惡除患
peld	貧而樂道
pf	剖分
pf	剖符
pf	剖腹
pf	平阜
pf	扒飯
pfcz	剖腹藏珠
pfcz	破釜沈舟
pfd	扒糞的
pfgm	披髮垢面
pfhds	蚍蜉撼大樹
pfhs	蚍蜉撼樹
pfhsd	捧鳳凰似的
pfmy	批風抹月
pfrs	披髮入山
pfrs	被髮入山
pfsc	剖腹生產
pfsne	裴夫斯奈爾
pfss	剖腹手術
pftm	披髮塗面
pfx	披腹心
pfyg	披髮纓冠
pfyg	被髮纓冠
pfyh	浦發銀行
pfyk	被髮佯狂
pfyk	被髮陽狂
pfzm	披髮藻目
pfzr	披髮左衽
pfzr	被髮左衽
pg	傍觀
pg	剖剮
pg	剖割
pg	匏瓜
pg	否隔
pga	膀胱癌
pgbs	傍觀必審
pgcq	披掛綽鎗
pgdl	盤古大陸
pgdyed	盆罐都有耳朵
pgdz	品高德重
pggd	披肝掛膽
pgj	膀胱鏡
pgjl	辟穀絕粒
pgkx	匏瓜空懸
pglcrs	屁股裏喫人參
pgld	剖肝瀝膽
pgld	披肝瀝膽
pgll	牌告利率
pglx	裴高累西
pgq	胚根鞘
pgqx	剖肝泣血
pgsz	披掛上陣
pgwy	破觚爲圜
pgy	膀胱炎
pgy	膀胱癌
pgyy	暴骨原野
pgzq	傍觀者清
ph	仳倠
ph	俳佪
ph	傍偟
ph	傍徨
ph	剖豁
phb	排行榜
phch	被褐藏輝
phdb	拼花地板
phdc	袍笏登場
phgc	披紅挂綵
phh	胖呵呵
phhb	被褐懷寶
phhj	被褐懷金
phhy	被褐懷玉
phhz	被褐懷珠
phj	平衡覺
phqc	平畫求長
phql	徘徊歧路
phql	徬徨歧路
phqt	徬徨歧途
phsc	彷徨失措
phsc	徬徨失措
phxj	撲花行徑
phyyy	裴航遇雲英
pj	丕基
pj	丕績
pj	便娟
pj	偏畸
pj	偏角
pjb	被甲兵
pjbt	否極必泰
pjch	破鏡重合
pjcy	破鏡重圓
pjdj	披荊帶棘
pjdq	平均地權
pjdqtl	平均地權條例
pjds	披枷帶鎖
pjdy	披金戴玉
pjj	披荊棘
pjjj	驃騎將軍
pjjl	攀車拒輪
pjk	配給卡
pjl	普及率
pjl	配給量
pjlgwsjj	潘金蓮給武松敬酒
pjlh	潘江陸海
pjp	配給品
pjp	配給票
pjrl	剖決如流
pjrn	皮嬌肉嫩
pjst	否極生泰
pjtk	扒街淘空
pjtl	否極泰來
pjwc	攀車臥轍
pjwz	攀車臥轍
pjxw	票據行爲
pjyz	破家鬻子
pjz	配給證
pjzd	配給制度
pjzj	披荊斬棘
pjzr	披堅執銳
pjzr	被堅執銳
pk	剖開
pk	披砍
pkdq	貧困地區
pl	㕷啦
pl	丕烈
pl	丕靈
pl	仳離
pl	剖路
pld	丕林島
pld	蒲隆地
pldghg	蒲隆地共和國
plgd	披瀝肝膽
plgd	披露肝膽
plhspblm	跑了和尚跑不了廟
pljh	潘陸江海
pljwses	裴萊吉伍斯二世
pljwsys	裴萊吉伍斯一世
plk	暴露狂
plm	拚老命
plpl	匹力撲六
plsb	辟歷施鞭
plwc	婆羅王朝
plx	破陸續
plx	霹靂弦
plxd	霹靂行動
plz	埔里鎮
plzn	毗盧遮那
plzx	炮烙之刑
pm	傍門
pm	剖明
pm	剖面
pm	媲美
pm	批抹
pmbh	匹馬不還
pmbwbc	罷馬不畏鞭箠
pmbwxf	罷民不畏刑法
pmc	披麻皴
pmdq	匹馬單鎗
pmds	披麻帶索
pmdx	披麻帶孝
pmh	拍賣行
pmhf	尨眉皓髮
pmjh	披麻救火
pmmx	跑馬賣解
pmpl	破麥破梨
pmqz	駢拇枝指
pmsj	泡沫塑膠
pmt	剖面圖
pmtq	拍馬挺鎗
pmwd	傍門外道
pmx	披毛犀
pmzn	摽梅之年
pmzx	跑馬走解
pn	便佞
pn	埤堄
pn	樸訥
pn	牝瘧
pn	胚囊
pncd	樸訥誠篤
pnry	毗尼日用
pns	婆那娑
po	妃耦
pp	丕丕
pp	丕平
pp	便便
pp	便辟
pp	偏裨
ppbb	琵琶別抱
ppbb	蓬蓬孛孛
ppc	琵琶蟲
ppd	嚭嚭地
ppd	琵琶調
ppg	枇杷膏
ppg	琵琶骨
pph	琵琶湖
pph	碰碰和
ppj	琵琶襟
ppj	琵琶記
ppj	琵琶鮫
ppjy	琵琶舊語
ppk	洴澼絖
ppl	琵琶錄
ppmx	枇杷門巷
ppp	琵琶譜
ppsb	毘婆沙部
ppsf	毗婆尸佛
ppx	琵琶行
ppxl	皮破血流
ppy	洴澼藥
ppy	琵琶魚
ppyf	胚培養法
ppz	平埔族
ppz	胼胚種
pq	偏棲
pq	傍妻
pq	扒竊
pq	拚卻
pq	拚棄
pqcg	烹犬藏弓
pqfx	披裘負薪
pqjx	破琴絕絃
pqtl	否去泰來
pqts	攀親託熟
pqw	蟠虯紋
pr	仆然
pr	傍人
pr	尨然
pr	皤然
pr	罷軟
prdc	旁人短長
prwr	傍若無人
prz	聘任制
ps	傍生
ps	剖視
ps	剖釋
ps	匹似
ps	扒上
psb	噴射泵
pscht	拚死喫河豚
psd	爬山調
psd	般涉調
psd	菩薩地
psdh	被山帶河
psds	拋聲調嗓
psj	裴少俊
psjj	披沙揀金
psjj	披沙簡金
psjs	拚生盡死
pslg	拋屍露骨
pslm	暴腮龍門
pslm	曝腮龍門
pslm	曝鰓龍門
psm	怕什麼
psm	憑什麼
psml	披霜冒露
pspdfsz	婆藪槃豆法師傳
pspf	毗舍婆佛
pssd	菩薩十地
pst	剖視圖
pst	朴實頭
psx	匹似閑
psx	譬似閑
psy	披蓑衣
psyl	扒山越嶺
psys	暴屍於市
psz	裴松之
pt	傍通
pt	否泰
pt	坯體
pt	扑撻
pt	扒推
ptcq	僕僮成羣
ptdt	普通地圖
ptfg	扳藤附葛
ptg	葡萄乾
ptgd	鋪天蓋地
ptj	攀庭檻
ptlm	拋頭露面
ptlqs	普陀洛伽山
ptsf	披頭散髮
ptsf	被頭散髮
ptshct	披頭四合唱團
ptst	普天率土
ptwg	抔土未乾
ptx	埤頭鄉
ptx	胚胎學
ptx	莆田縣
ptxz	披頭跣足
ptys	潑天也似
ptz	毘曇宗
ptzd	葡萄炸彈
pw	披味
pw	披屋
pw	披文
pw	披玩
pw	盤渦
pwb	潘瑋柏
pwgc	片瓦根椽
pwlzzd	貧無立錐之地
pwpx	佩韋佩弦
pwtl	否往泰來
px	丕顯
px	佩弦
px	佩觿
px	便嬛
px	傍系
pxb	貧血病
pxbq	平行表親
pxc	胚形成
pxcg	剖心坼肝
pxcx	皮下出血
pxdc	品行端醇
pxdk	批郤導窾
pxdw	爬行動物
pxdy	披星帶月
pxdy	披星戴月
pxf	披心腹
pxgh	螃蟹過河
pxgs	平行官署
pxhsx	偏向虎山行
pxj	裴行儉
pxjd	培訓基地
pxjt	拍膝嗟歎
pxl	疋先裏
pxlmt	平行六面體
pxm	平行脈
pxnd	鋪胸納地
pxp	拍胸脯
pxqg	排泄器官
pxs	旁行書
pxsbx	平行四邊形
pxsr	平行輸入
pxw	平行文
pxw	排泄物
pxx	埔心鄉
pxx	平行線
pxx	莆仙戲
pxx	飄香屑
pxxg	剖心析肝
pxxq	旁系血親
pxxs	旁行斜上
pxxtjd	配線系統接地
pxxzp	平行線支票
pxyf	馮虛御風
pxym	平行葉脈
py	丕業
py	便宜
py	便言
py	僕射
py	埤雅
pybgdj	便宜不過當家
pybm	罷於奔命
pybsdj	便益不失當家
pyg	僕射姑
pyh	便宜話
pyh	便宜貨
pyh	鄱陽湖
pyhpy	鄱陽湖平原
pyj	披衣菌
pyky	匏有苦葉
pylc	破衣拉裳
pym	培養皿
pym	摽有梅
pym	胚芽米
pymhh	便宜沒好貨
pyn	披亞諾
pyq	番禺區
pyq	胚芽鞘
pyry	聘用人員
pywc	攀轅臥轍
pywdqt	披雲霧睹青天
pywhh	便宜無好貨
pywz	攀轅臥轍
pyx	番禺縣
pyy	培養液
pyz	平妖傳
pyzy	便宜主義
pz	偏重
pz	傍尊
pz	僕從
pz	劈着
pz	匏尊
pzb	拍紙簿
pzbs	貧嘴薄舌
pzbw	弸中彪外
pzbx	平章百姓
pzcl	披榛採蘭
pzet	否終而泰
pzf	辟支佛
pzhx	披枝害心
pzjx	扑作教刑
pzlbcq	破蒸籠不盛氣
pzlrz	蠙珠來入掌
pzms	朴資茅斯
pzmsty	朴資茅斯條約
pzs	朴子市
pzsm	般舟三昧
pzts	品竹彈絲
pzts	品竹調絲
pztx	品竹調弦
pzwg	貔子窩港
pzx	朴正熙
pzxy	披針形葉
pzxyxz	疱疹性咽狹症
pzy	破陣樂
pzypdl	披着羊皮的狼
q	㐀
q	㐤
q	㐸
q	㐹
q	㑋
qa	曲拗
qb	仟伯
qb	啓白
qb	將伯
qb	岐伯
qb	峭薄
qbd	氣爆彈
qbdj	遣兵調將
qbjy	彊本節用
qbjy	敲冰戛玉
qbl	慶伯利
qbl	齊伯林
qblb	錢不露白
qbrm	彊本弱末
qbs	前半晌
qbs	恰便似
qbwx	輕薄無行
qbwz	輕薄無知
qby	蘧伯玉
qbz	卡脖子
qbzc	前不着村
qbzchbzd	前不着村後不着店
qbzz	將伯之助
qc	傔從
qc	全長
qc	前仇
qc	前朝
qc	取償
qcbd	七長八短
qcbd	取長補短
qcdc	欽差大臣
qcdf	噙齒戴髮
qcf	前車覆
qcfzf	扦插繁殖法
qcgsybj	全彩乾式印表機
qchd	前長後短
qchy	汽車行業
qcjc	輕車簡從
qcjs	輕車介士
qcjz	輕車簡從
qck	請參考
qckj	前車可鑒
qcld	窮愁潦倒
qcqs	籧篨戚施
qcry	其從如雲
qcsc	詘寸伸尺
qcsc	詘寸信尺
qcsj	前程似錦
qcsl	輕車熟路
qcwh	千仇萬恨
qcwx	氣充文見
qcx	齲齒笑
qcxl	驅蟲效率
qcxx	氣喘吁吁
qcy	請參閱
qczd	情長紙短
qczj	前車之鑑
qczj	前車之鑒
qczl	汽車租賃
qczs	輕財重士
qczy	輕財重義
qczz	羣雌粥粥
qd	乾斷
qd	乾旦
qd	乾道
qd	勍敵
qd	千石
qdbz	七跌八撞
qdf	卿大夫
qdhs	強敵環伺
qdht	搶地呼天
qdqc	棄短取長
qds	麯道士
qdwg	千刀萬剮
qdx	鉛刀銛
qdzx	琴斷朱弦
qe	卷阿
qe	愆痾
qe	青蚵
qf	前番
qf	卷髮
qf	愆伏
qf	緝訪
qf	蜷伏
qfbj	萋斐貝錦
qfcx	齊傅楚咻
qfjh	七返九還
qfjj	清風勁節
qfx	曲阜縣
qfz	千夫長
qfzq	傾覆重器
qg	乾綱
qg	悛改
qg	悛革
qg	耆耇
qg	蹻工
qgbs	強聒不舍
qgch	氣貫長虹
qgd	起高調
qgez	曲肱而枕
qggd	全國各地
qgl	禽滑釐
qgld	起根立地
qgrz	彊幹弱枝
qgtd	情感天地
qgyh	器官銀行
qgyz	棋高一着
qgzc	切骨之仇
qgzl	曲肱之樂
qgzw	裘葛之遺
qh	丘壑
qh	乾和
qh	乾紅
qh	圊圂
qh	愜懷
qhbg	戕害不辜
qhbs	欺行霸市
qhhpd	青海湖盆地
qhqz	權衡輕重
qhxp	氣夯胸脯
qhyj	強還原劑
qj	傾家
qj	傾角
qj	全角
qj	切角
qj	取給
qjbs	棄車保帥
qjbs	淺見薄識
qjbw	彊記博聞
qjf	前車覆
qjfc	麇集蜂萃
qjfm	全軍覆沒
qjg	親家公
qjgx	奇節瑰行
qjj	將進酒
qjjc	輕車簡從
qjjs	輕車介士
qjjy	瓊漿金液
qjjz	輕車簡從
qjkj	前車可鑒
qjl	秦吉了
qjld	親家禮道
qjly	親家老爺
qjm	親家母
qjpgd	起雞皮疙瘩
qjqw	強記洽聞
qjsl	輕車熟路
qjsy	雀角鼠牙
qjtf	擒奸摘伏
qjtf	擒姦擿伏
qjw	親家翁
qjxw	強記洽聞
qjyb	棄甲曳兵
qjyq	敲擊樂器
qjyy	敲擊音樂
qjyy	瓊漿玉液
qjyz	情節嚴重
qjz	去角質
qjzf	千鈞重負
qjzj	前車之鑑
qjzj	前車之鑒
qk	乾坤
qk	嗆咳
qk	契闊
qk	拑口
qk	掮客
qkbs	輕口薄舌
qkdj	傾筐倒庋
qkfc	禽困覆車
qkfj	禽困覆車
qkjs	鉗口撟舌
qklx	七孔流血
qkty	契闊談讌
qkyz	乾坤一擲
qkzgy	青康藏高原
qkzz	乾坤再造
ql	乾陵
ql	乾隆
ql	伽藍
ql	卷婁
ql	取樂
qlbd	七了八當
qlbd	千了百當
qlbq	其樂不窮
qlbydts	強龍不壓地頭蛇
qld	鎗榴彈
qldcp	千里搭長棚
qldl	乞留玎琅
qldy	槍林彈雨
qlfb	輕浪浮薄
qlkc	嘁哩喀喳
qlkk	慳吝苦剋
qllg	虯鏤亮槅
qln	伽藍鳥
qlrr	其樂融融
qls	棲流所
qltt	千里迢迢
qlty	千里迢遙
qlwb	其樂無比
qlwq	其樂無窮
qlyx	千里移檄
qlz	仡佬族
qlz	犵狫族
qlzd	千里之堤
qlzt	千里之堤
qlzx	千里之行
qm	侵牟
qm	僉謀
qm	厹矛
qm	器皿
qm	愆面
qmcj	犬馬齒殲
qmqy	喬模喬樣
qmtx	全面推行
qmy	俏模樣
qmyq	氣鳴樂器
qn	去呢
qn	唼佞
qn	岐嶷
qn	慳囊
qn	汽輾
qnd	囚攮的
qnn	親奶奶
qnsd	耆年碩德
qntdbbz	千年田地八百主
qnx	伽南香
qnzm	彊弩之末
qo	仇偶
qp	傾圮
qp	奇葩
qp	敲扑
qp	殼牌
qp	求聘
qpd	清平調
qphj	前仆後繼
qphq	前仆後起
qpp	氣丕丕
qpyh	奇葩異卉
qq	乾乾
qq	仇仇
qq	伽伽
qq	前愆
qq	卷卷
qqcc	嘁嘁喳喳
qqcc	萋萋綽綽
qqg	乾清宮
qqgj	羣起攻訐
qqhh	棲棲遑遑
qqll	蹌蹌踉踉
qqns	繾綣難捨
qqpb	取青媲白
qqss	乞乞縮縮
qqwc	千岐萬轍
qqwh	欠錢未還
qqwz	千岐萬轍
qqxw	侵權行爲
qqzg	搴旗斬馘
qqzz	羣輕折軸
qr	悛容
qr	愀然
qr	洽濡
qr	虯髯
qrbm	棄如弁髦
qrk	虯髯客
qrkz	虯髯客傳
qrsbl	強如手撥剌
qrsd	耆儒碩德
qrsl	耆儒碩老
qrsw	耆儒碩望
qs	佉沙
qs	僉事
qs	全盛
qs	前晌
qs	千乘
qsbt	琴瑟不調
qsce	勸善黜惡
qsckz	羣蝨處褌中
qsdc	秋收冬藏
qseds	七十二地煞
qseh	七十二行
qsgh	泉石膏肓
qskx	切實可行
qsl	慳嗇霖
qspb	氣勢磅礡
qspb	氣勢磅礴
qsqx	稽顙泣血
qsrt	稽顙肉袒
qssh	情深似海
qsss	胠沙思水
qsst	琴瑟失調
qsth	琴瑟調和
qswh	千山萬壑
qswj	千乘萬騎
qsxt	琴瑟相調
qsy	清商樂
qsyy	氣盛言宜
qsyz	情深意重
qsyz	情深義重
qszb	輕事重報
qszd	潛水炸彈
qszy	輕生重義
qszy	輕身重義
qt	乾圖
qt	俔天
qt	僉同
qt	愆忒
qt	愜貼
qtbrmdh	青天白日滿地紅
qtck	親痛仇快
qtdf	其他地方
qtdq	其他地區
qthy	其他行業
qtjd	窮天極地
qtjh	檠天架海
qtkd	欺天誑地
qtld	窮途潦倒
qtlt	窮途落魄
qtry	氣態溶液
qtsj	前途似錦
qtt	親太太
qtwd	欺天罔地
qtyq	情投意洽
qtyx	情投意洽
qw	僉望
qw	洽聞
qw	葺屋
qw	蜷蜿
qw	親翁
qwb	翹尾巴
qwbj	洽聞博見
qwcj	去蕪存菁
qwh	全武行
qwl	薔薇露
qwpzy	秦王破陣樂
qwqj	洽聞強記
qwsz	棲梧食竹
qwzj	遒文壯節
qx	乞降
qx	乾象
qx	侵削
qx	傾泄
qx	傾陷
qxbx	曲學詖行
qxd	棲息地
qxes	曲學阿世
qxf	強行法
qxhc	情見乎辭
qxhx	跂行喙息
qxhy	情見乎言
qxj	傾斜角
qxj	強行軍
qxjc	祁奚薦仇
qxjy	清新雋永
qxk	緝鞋口
qxlq	情見力屈
qxlq	綦谿利跂
qxq	七弦琴
qxqs	泣血稽顙
qxqt	且行且談
qxrw	窮纖入微
qxsj	情見勢竭
qxsq	情見勢屈
qxsx	全血輸血
qxtc	器械體操
qxtx	屈膝投降
qxtx	棄械投降
qxx	氣吁吁
qxx	氣咻咻
qxxs	謙遜下士
qy	乾元
qy	乾曜
qy	仇英
qy	傾軋
qy	僉押
qybf	輕徭薄賦
qybs	輕徭薄稅
qyjs	祇洹精舍
qykd	羣蟻潰堤
qykt	羣蟻潰堤
qysl	窮源溯流
qyss	氣咽聲絲
qywh	千巖萬壑
qyxx	企業行銷
qyxz	氣焰囂張
qyy	輕音樂
qyyz	犬牙鷹爪
qz	乾宅
qz	乾造
qz	傔卒
qz	傔從
qz	前傳
qzbs	輕嘴薄舌
qzdz	輕重倒置
qzgy	青藏高原
qzhj	輕重緩急
qzhq	欠債還錢
qzj	起重機
qzjc	輕裝簡從
qzjz	輕裝簡從
qzrs	情重如山
qzrw	趨之若鶩
qzry	其從如雲
qzsy	輕重失宜
qzt	青貯塔
qztl	青藏鐵路
qztl	麇至沓來
qzwh	欠債未還
qzwh	欠帳未還
qzx	請自行
qzxc	騎自行車
qzxt	卻做餳糖
qzyrsfl	茄子也讓三分老
qzzd	酋長制度
qzzl	衾枕之樂
qzzx	強制執行
r	ㄖ
r	㐡
r	㐵
r	㑱
r	㒄
rb	乳哺
rb	熱泵
rb	蕊榜
rbn	冉伯牛
rbqs	人百其身
rbxj	日不暇給
rbxs	日薄西山
rbyg	日不移晷
rbzys	染不着顏色
rc	人畜
rc	入朝
rc	容車
rc	爇櫬
rc	肉畜
rcb	如椽筆
rcl	容長臉
rcml	揉眵抹淚
rcnh	惹草粘花
rcsj	日長歲久
rcsz	如痴似醉
rcxj	肉顫心驚
rcyc	如出一轍
rcyc	若出一轍
rcyx	日長一線
rcyz	如出一轍
rcyz	若出一轍
rd	人地
rd	偌多
rd	偌大
rd	入地
rd	壤地
rdl	熱導率
rdls	人地兩疏
rdss	人地生疏
rdsyy	熱地上蚰蜒
rdwm	入地無門
rdxy	人地相宜
rebq	稔惡不悛
rf	肉脯
rfly	如奉綸音
rg	日晷
rg	肉乾
rgfz	人工繁殖
rgjg	燃膏繼晷
rgy	日晷儀
rgyz	人工養殖
rh	人行
rh	戎行
rh	熱和
rh	糅合
rh	若還
rhct	熱火朝天
rhdf	任何地方
rhjx	如何進行
rhsj	如花似錦
rhsy	如花似月
rhsy	如花似玉
rhsz	如幻似真
rhzq	惹禍招愆
rj	入覲
rj	容車
rj	撋就
rj	日給
rj	日腳
rjcay	日近長安遠
rjdl	人傑地靈
rjdy	人間地獄
rjjz	人給家足
rjl	容積率
rjsk	如飢似渴
rjsk	如饑似渴
rjsq	如膠似漆
rjtc	日久天長
rjyx	日朘月削
rjyy	日角偃月
rjzt	日角珠庭
rjzx	如箭在弦
rkl	肉傀儡
rkz	日喀則
rkzrzjl	人口自然增加率
rl	稔亂
rl	軟肋
rl	頌禮
rl	饒樂
rlbb	如履薄冰
rlpd	如履平地
rlsh	如狼似虎
rlyh	人力銀行
rlz	如來藏
rm	恁麼
rm	日沒
rm	辱抹
rm	辱沒
rmcj	如夢初覺
rmhc	濡沫涸轍
rmhz	濡沫涸轍
rms	軟木塞
rmsh	如夢似幻
rmx	軟瞇𥉐
rmyh	人民銀行
rmyx	茹毛飲血
rmyy	熱門音樂
rn	嚅囁
rn	嬈惱
rn	柔嫩
rn	柔懦
rn	稔膩
rnfz	如牛負重
rngd	柔懦寡斷
rpld	人怕落囤
rpxw	韌皮纖維
rq	婼羌
rq	融洽
rqbsz	人情薄似紙
rqdbl	人勤地不懶
rr	䰰䰰
rr	嶸嶸
rr	蠕蠕
rrfz	忍辱負重
rrxx	溶溶泄泄
rs	人參
rs	偌時
rs	妊娠
rs	容俟
rs	稔色
rsbx	人事不省
rsdf	人聲鼎沸
rsdj	如拾地芥
rsdl	忍受得了
rsdxx	人是地行仙
rsdxz	妊娠毒血症
rsfl	肉山脯林
rsg	人參果
rsj	入射角
rsj	日射角
rslbs	人生路不熟
rsmbs	人生面不熟
rsrzl	人生如朝露
rss	人是誰
rstc	饒舌調脣
rsw	妊娠紋
rswc	日誦五車
rswj	日誦五車
rsxz	人事行政
rsys	人是衣裳
rszd	容身之地
rszf	如釋重負
rszf	若釋重負
rszgsws	人生自古誰無死
rszl	人生朝露
rt	柔荑
rtcm	人頭畜鳴
rtcsh	日頭常晌午
rtcsw	日頭常晌午
rtld	人頭落地
rtp	軟調脾
rtyh	軟體銀行
rwdlx	人文地理學
rwhc	人文薈萃
rwty	人物闐咽
rx	乳臭
rx	任囂
rx	容臭
rx	揉弦
rx	榮行
rxd	人行道
rxdw	蠕形動物
rxft	熱血沸騰
rxql	日行千里
rxrc	如壎如箎
rxst	人心似鐵
rxwg	乳臭未乾
rxwq	燃犀溫嶠
rxxz	乳臭小子
rxyj	日削月朘
rxyk	日省月課
rxys	日省月試
rxys	日行一善
ry	溶㵝
ry	溶液
ry	融泄
ryb	榮譽榜
rycg	日月重光
ryhw	若有還無
rysc	日月參辰
ryss	如魚似水
ryth	如飲醍醐
rywh	日飲亡何
ryxyx	如衣繡夜行
ryyc	如願以償
ryyc	日引月長
ryzz	人言鑿鑿
rz	戎旃
rz	撋縱
rz	熱軋
rz	稔知
rz	糅雜
rzcx	染指垂涎
rzd	容足地
rzdy	任重道遠
rzny	柔枝嫩葉
rzqj	肉重千斤
rzsy	如珠似玉
rzw	熱爪哇
rzxj	肉顫心驚
rzxw	人造纖維
rzy	乳濁液
rzyc	揉着癢處
rzys	仁者樂山
rzzq	惹罪招愆
rzzy	任重致遠
s	ㄕ
s	ㄙ
s	㑉
s	㑐
s	㑗
sa	山隘
sa	樞奧
sa	熟諳
sa	誰啊
sb	上榜
sb	世伯
sb	什伯
sb	什百
sb	伺便
sbal	四不拗六
sbbc	死鰾白纏
sbcdy	十八層地獄
sbcq	松柏長青
sbcqc	松柏長青茶
sbcr	食不重肉
sbcw	食不重味
sbcx	手背朝下
sbd	塞班島
sbdc	山崩地坼
sbdl	山崩地裂
sbdx	山崩地陷
sbe	蘇泊爾
sbgs	少不更事
sbhd	松柏後凋
sbjc	松柏節操
sbjs	少不更事
sbl	上不了
sbl	受不了
sbl	守備率
sbl	少不了
sbl	死不了
sbls	盛必慮衰
sblsh	三百六十行
sbltm	上不了臺面
sblz	樹碑立傳
sbmm	死不瞑目
sbs	上半晌
sbs	史賓塞
sbs	斯賓塞
sbt	舒伯特
sbws	盛不忘衰
sbx	什不閑
sbx	山萆薢
sbxy	食不下咽
sby	塞爆音
sby	松柏園
sbz	水筆仔
sbz	睡不着
sbzj	松柏之堅
sbzm	松柏之茂
sbzs	松柏之壽
sc	三重
sc	上剎
sc	上朝
sc	世仇
sc	伸長
scb	水錘泵
scbl	深沈不露
scbl	深藏不露
sccw	殺出重圍
scd	手長的
scd	說長短
scdc	市場調查
scdd	說長道短
scdh	深仇大恨
scdy	市場調研
scgj	雙重國籍
scgl	輸出功率
scgm	神出鬼沒
scgs	神差鬼使
schq	市場行情
scj	收藏夾
scj	收藏家
scj	睡長覺
scjd	生產基地
scjy	時絀舉贏
scjz	收藏價值
sckz	蝨處褌中
scl	生產率
scld	三長兩短
scld	說長論短
scm	三重門
scmy	參辰卯酉
scn	伺晨鳥
scp	三重埔
scp	收藏品
scpd	四川盆地
scq	說參請
scqy	上朝取應
scrg	雙重人格
scrx	深藏若虛
scry	參辰日月
scsd	是長是短
scsd	設朝升殿
scsd	說長說短
scsf	山重水複
scsf	雙重身分
scsj	死喫死嚼
scsy	山長水遠
scw	誰承望
scwz	少喫無着
scxl	生產效率
scxs	似曾相識
scy	塞擦音
scyd	拴搐豔段
scyd	深藏遠遁
scyl	三朝元老
scyxd	手長衣袖短
scyz	水產養殖
scz	侍從長
scz	四重奏
scz	收藏者
sczhq	塞車症候羣
sczy	三長齋月
sczy	疏財重義
sczyl	市場占有率
sd	三地
sd	上地
sd	似地
sd	似的
sd	倏地
sdb	石刁柏
sdbg	蘇打餅乾
sdbl	速動比率
sdbld	山地保留地
sdbm	盛德不泯
sdbt	縮地補天
sdc	說短長
sdcc	舍短從長
sdch	市地重劃
sdcm	掃地出門
sddc	說短道長
sdec	善刀而藏
sdf	三都賦
sdf	屬地法
sdf	生地方
sdfd	似懂非懂
sdfh	聲調符號
sdg	塞得港
sdgxp	斯多噶學派
sdgzq	山地管制區
sdgzylq	山地管制遊覽區
sdh	誰都會
sdjc	首都機場
sdjj	掃地俱盡
sdjs	熟讀精思
sdkl	聖誕快樂
sdl	受得了
sdl	算得了
sdl	薩都剌
sdlb	勢單力薄
sdlc	數短論長
sdlc	舍短錄長
sdlc	說短論長
sdlj	水斷陸絕
sdlsm	算得了什麼
sdm	燒地眠
sdnm	失地農民
sdqc	捨短取長
sdqc	舍短取長
sdqs	死地求生
sdsb	山地山胞
sdsj	實彈射擊
sdsl	攝大乘論
sdtb	山地同胞
sdtt	掃地滔天
sdtt	說地談天
sdtx	所得彈性
sdw	山地舞
sdwc	書讀五車
sdwj	書讀五車
sdwsh	熟讀王叔和
sdww	熟讀玩味
sdwy	掃地無餘
sdxd	閃電行動
sdyc	舍短用長
sdyc	身段勻稱
sdyf	盛德遺範
sdyg	聖地牙哥
sdyx	聖德懿行
sdyxz	射鵰英雄傳
sdz	說得着
se	俞兒
se	塞爾
se	塞耳
se	宿痾
se	山阿
secg	率爾操觚
secz	率爾成章
sedz	塞耳盜鐘
sehzz	薩爾滸之戰
setl	塞耳偷鈴
sezcky	十二指腸潰瘍
sf	三幡
sf	三番
sf	十番
sf	嗄飯
sf	弛廢
sfdm	十方地面
sfdm	召父杜母
sfjd	示範基地
sfl	說服力
sflc	三番兩次
sfnr	歲豐年稔
sfq	伺服器
sfsf	三番四復
sfsm	夙負盛名
sfsq	三風十愆
sfts	塞凡提斯
sfwc	三番五次
sfwc	書富五車
sfwj	書富五車
sfxx	師範學校
sfxz	司法行政
sfxzb	司法行政部
sfyy	隨風搖曳
sfzd	是非之地
sfzy	十分重要
sg	三皈
sg	刷括
sg	商賈
sg	善賈
sg	塑鋼
sgbj	神鬼不覺
sgd	塞狗洞
sgdf	笙歌鼎沸
sgdj	雙柑斗酒
sgdps	水過地皮溼
sgg	瘦括括
sgh	桑乾河
sghl	葉公好龍
sgjj	殊功勁節
sgl	絲瓜絡
sglrdwg	誰敢留人到五更
sglz	山旮旯子
sgpd	桑乾盆地
sgpd	輸肝剖膽
sgq	盛果期
sgsc	山高水長
sgsj	時光似箭
sgsj	韶光似箭
sgt	蘇公隄
sgyn	深耕易耨
sgz	涮鍋子
sgzd	事關重大
sgzd	笙歌匝地
sgztclw	十個指頭朝裏彎
sgztycd	十個指頭有長短
sgztyzdt	十個指頭咬着都痛
sgzz	書歸正傳
sh	上浣
sh	世行
sh	似乎
sh	似火
sh	俟候
shax	聳壑昂霄
shck	四行倉庫
shd	送還到
shdc	社會調查
shdf	四海鼎沸
shdq	上海地區
shdqj	睡虎地秦簡
shds	雙核都市
shdw	社會地位
shg	燒火焜
shg	送還給
shgj	四行孤軍
shh	傻呵呵
shh	說諢話
shjs	社會角色
shjs	隨行就市
shjx	十行俱下
shlj	身懷六甲
shlq	三好兩怯
shpc	損害賠償
shsb	歲寒松柏
shsr	時和歲稔
shst	社會失調
shts	社會調適
shw	晌午歪
shx	三和弦
shxw	社會行爲
shz	樹行子
shz	水滸傳
shz	生還者
shzf	扇火止沸
shzgj	社會總供給
shzk	索還債款
shzq	俟河之清
sj	䈰箕
sj	䈾箕
sj	三角
sj	上勁
sj	什錦
sjb	三角板
sjb	三角表
sjb	塑膠布
sjbl	塑膠玻璃
sjblbh	三句不離本行
sjbs	捨車保帥
sjbs	盛極必衰
sjbx	數見不鮮
sjc	三角尺
sjc	時間長
sjcj	視覺衝擊
sjcl	三角測量
sjcs	散騎常侍
sjct	四腳朝天
sjd	三角點
sjd	塑膠袋
sjdc	身家調查
sjdqr	世界地球日
sjdr	審己度人
sjed	伺機而動
sjes	拾級而上
sjf	三角楓
sjf	三角法
sjfcs	三角方程式
sjgd	世界各地
sjgy	塑膠工業
sjh	塑膠花
sjhb	塑膠貨幣
sjhmjzf	四角號碼檢字法
sjhmmcx	三腳蝦蟆沒處尋
sjhq	神機火鎗
sjhs	三角函數
sjhx	舒筋活血
sjj	三角巾
sjj	三角江
sjj	三角肌
sjjbzf	三角巾包紮法
sjjc	深居九重
sjjq	四角俱全
sjjz	宿將舊卒
sjk	三角褲
sjkj	視覺空間
sjl	三觭龍
sjla	三角戀愛
sjlx	宋斤魯削
sjlx	尸居龍見
sjmj	數奇命蹇
sjmn	釋迦牟尼
sjmxt	事急馬行田
sjmy	三角貿易
sjn	臊羯奴
sjn	誰叫你
sjpc	詩酒朋儕
sjq	睡覺前
sjq	視覺器
sjqasj	三聚氰胺塑膠
sjrs	似箭如梭
sjsx	豕交獸畜
sjsy	視覺適應
sjt	三角鐵
sjth	三角套匯
sjwx	社稷爲墟
sjx	三角學
sjx	三角形
sjx	四加行
sjxd	實際行動
sjxg	視覺效果
sjxt	三角習題
sjxw	神經纖維
sjxy	視覺懸崖
sjxz	聖經賢傳
sjy	三角眼
sjyh	世界銀行
sjyh	歲朘月耗
sjys	盛極一時
sjys	視覺藝術
sjz	三角柱
sjz	三角洲
sjz	三角錐
sjzc	時間最長
sjzc	社稷之臣
sjzd	塑膠炸彈
sjzj	樞機主教
sjzl	聲跡彰露
sjznwy	誰家竈內無煙
sjzq	社稷之器
sjzs	神經中樞
sk	宋牼
sk	歲會
sk	沈括
sk	漱口
sk	熟客
skdh	撒科打諢
skdnwy	斯堪的納維亞
skdnwybd	斯堪的那維亞半島
skjl	司空伎倆
skkq	盛況空前
skl	屎蚵蜋
sks	漱口水
sl	三樂
sl	上僂
sl	傻樂
sl	勝率
sl	受賂
slbc	水陸畢陳
slbj	水陸並進
slbx	勢力並行
slct	十里長亭
slcy	溯流徂源
slcy	溯流從源
sld	手榴彈
sldc	水陸道場
sldf	三閭大夫
slf	賽璐玢
slh	叔梁紇
slh	水陸畫
slhc	說來話長
slj	睡懶覺
sljx	順利進行
slm	耍流氓
slm	莎樂美
slqc	熟路輕車
slqc	熟路輕轍
slqj	熟路輕車
slqq	深厲淺揭
slqy	溯流求源
slqz	熟路輕轍
slsn	水利樞紐
sltd	生靈塗地
slx	食廩餼
slxw	司隸校尉
slxy	聖露西亞
slyc	樗櫟庸材
slylq	森林遊樂區
slyw	三氯乙烷
slyx	三氯乙烯
slzc	水陸雜陳
slzs	漱流枕石
slzs	霜露之思
slzw	熟練掌握
slzz	水陸之饌
sm	乘馬
sm	什面
sm	什麼
sm	俟命
sm	塞滿
sma	什麼啊
smb	什麼病
smc	什麼車
smca	索米長安
smcd	什麼程度
smct	四馬攢蹄
smct	素面朝天
smcx	蘇門長嘯
smczb	石棉沉着病
smd	三摩地
smd	什麼的
smd	水磨調
smdb	實木地板
smdd	什麼東東
smdf	什麼地方
smdj	生毛帶角
smdx	什麼東西
smg	什麼歌
smgx	什麼關係
smh	什麼好
smh	什麼話
smhy	死模活漾
smj	三面角
smj	什麼叫
smjz	什麼叫做
sml	宿命論
smlj	聲名狼藉
smlp	三媒六聘
smmc	神祕莫測
smmz	什麼名字
smn	什麼呢
smnf	盛名難副
smpz	什麼牌子
smqj	四門親家
smqk	什麼情況
smr	什麼人
smr	熟面人
sms	什麼書
sms	摔馬杓
sms	樞密使
smsh	什麼時候
smsj	什麼時間
smsl	熟門熟路
smsm	說明什麼
smsq	什麼事情
smsr	善馬熟人
smt	宿命通
smt	水門汀
smwt	什麼問題
smy	什麼樣
smy	什麼用
smy	什麼藥
smy	樞密院
smyh	十目一行
smyj	率馬以驥
smys	什麼意思
smys	什麼顏色
smys	拭目以俟
smyy	什麼原因
smyy	深謀遠猷
smyz	什麼樣子
smzc	手面賺喫
smzcsf	生米做成熟飯
smzcsf	生米煮成熟飯
smzy	什麼作用
sn	召南
sn	嗩吶
sn	塞內
sn	宿諾
sn	撒溺
snb	雙捻布
snc	嗩吶草
snh	塞納河
snje	塞內加爾
snjeghg	塞內加爾共和國
snnf	少女嫩婦
snqt	瑟弄琴調
snsl	水泥熟料
snsq	熟能生巧
snwg	誰能無過
snwq	誰能無情
snx	素女弦
sny	室內樂
snyjyzm	十年一覺揚州夢
sp	三辟
sp	伸剖
sp	受聘
sp	樗蒲
sp	殺坯
spd	四平調
spd	山坡地
spdby	山坡地保育
sph	廝撲行
spj	手扒雞
spx	松皮癬
spz	審判長
sq	什器
sq	僧伽
sq	史鰌
sq	哨卡
sq	唼氣
sqc	鼠麯草
sqcy	勢傾朝野
sqd	熟切店
sqej	歙漆阿膠
sqgy	山棲谷飲
sqjm	繩愆糾謬
sql	僧伽藍
sqlr	盛氣凌人
sqlr	盛氣臨人
sqnq	盛情難卻
sqpn	善巧便佞
sqrj	似漆如膠
sqss	雙棲雙宿
sqxx	暑期學校
sqz	三七仔
sr	宿儒
sr	懾人
sr	撣人
sr	熟人
sr	熟稔
srbgc	濕肉伴乾柴
srbgtdd	殺人不過頭點地
srbjx	殺人不見血
srbzdrz	雙日不着單日着
srcj	視如草芥
srcj	視若草芥
srcm	殺人償命
srdy	誰入地獄
srkl	生日快樂
srn	誰讓你
srnf	歲稔年豐
srrj	殺人如芥
srtj	視如土芥
srtt	拾人涕唾
srx	三人行
srxbyws	三人行必有我師
srxjx	殺人須見血
srxp	懾人心魄
sryhyw	私人銀行業務
srzz	收入增長
ss	三乘
ss	三省
ss	上乘
ss	上宿
ss	上溯
ssas	色衰愛弛
ssb	生死簿
ssc	所所長
sscc	善善從長
sscd	設身處地
ssds	審時度勢
ssds	隨時度勢
ssdz	尚書大傳
ssef	似是而非
ssex	三思而行
ssfc	水宿風餐
ssg	熟石膏
ssh	十三行
ssh	熟石灰
sshs	十四行詩
sshyz	十三行遺址
ssj	睡晌覺
ssjg	石室金匱
ssl	宿舍樓
ssl	收視率
ssl	熟商量
sslb	盛食厲兵
sslh	三十六行
sslh	盛衰利害
ssly	詩書禮樂
sslz	三十六着
ssm	算什麼
ssm	縮砂蔤
ssmybn	說什麼也不能
ssnn	縮縮朒朒
sspg	縮手旁觀
ssq	塞上曲
ssqh	盛暑祁寒
ssqk	死生契闊
ssqy	聲絲氣咽
ssrg	生死肉骨
ssrk	盛衰榮枯
ssrr	盛衰榮辱
ssry	似水如魚
sss	誰是誰
sssd	隨時隨地
sssf	雙宿雙飛
sssr	率獸食人
sswd	熟視無睹
sswe	善善惡惡
sswy	桑樞甕牖
ssxc	盛衰相乘
ssxc	順水行船
ssxf	盛衰興廢
ssxh	屍山血海
ssxj	死傷相藉
ssxx	束身修行
ssxz	莘莘學子
ssxz	順水行舟
ssyj	宿世冤家
ssyl	神荼鬱壘
ssyz	盛飾嚴裝
ssz	司司長
ssz	是誰在
sszd	深水炸彈
sszd	首善之地
sszh	說詩啐話
sszl	漱石枕流
sszs	繩樞之士
sszy	事生肘腋
st	伺探
st	參湯
st	召棠
st	唆調
st	宿頭
stdw	生態地位
stgd	掃田刮地
stgx	率土歸心
sths	上廳行首
stlx	身體力行
stqn	瑟調琴弄
strd	上天入地
stsd	說天說地
stsj	少調失教
stst	淑慝殊途
sttq	率土同慶
stz	熟套子
stzb	率土之濱
stzx	率土宅心
sw	什物
sw	塞外
sw	宿望
sw	宿衛
sw	宿霧
swbrg	書無百日工
swcz	縮屋稱貞
swdalb	沙烏地阿拉伯
swdalbwg	沙烏地阿拉伯王國
swfs	舍我復誰
swj	睡午覺
swjf	死亡給付
swl	死亡率
swl	鰓尾類
swly	塞維利亞
swqh	深文巧劾
swqs	捨我其誰
swqs	舍我其誰
swsd	斯文掃地
swsm	塞翁失馬
swsz	熟魏生張
swtebx	蛇無頭而不行
swtj	深惡痛嫉
swtj	深惡痛絕
sww	晌午歪
swwd	斯文委地
swyx	示威遊行
swzj	傷亡枕藉
swzszd	死無葬身之地
swzw	身無長物
swzx	身無擇行
swzz	視微知著
sx	三弦
sx	三省
sx	上弦
sx	上校
sx	事畜
sxbl	省刑薄斂
sxbl	素行不良
sxbs	手寫辨似
sxbt	水泄不通
sxbx	私校保險
sxc	受降城
sxc	散血草
sxcj	私心藏奸
sxcs	甚囂塵上
sxd	實心彈
sxdd	死心倒地
sxdd	死心搭地
sxdl	受降典禮
sxe	塞席爾
sxeghg	塞席爾共和國
sxfs	生息蕃庶
sxh	盛宣懷
sxh	雙線行
sxj	扇形角
sxjg	塑性加工
sxjr	宿學舊儒
sxkg	瘦小枯乾
sxl	升學率
sxls	賞心樂事
sxlx	身陷縲絏
sxpm	所向披靡
sxq	四弦琴
sxq	塞下曲
sxs	三弦書
sxsbdsr	手心手背都是肉
sxskq	吮吸式口器
sxt	耍噱頭
sxtd	死心塌地
sxtq	時行天氣
sxwj	肆行無忌
sxx	上行星
sxxx	上行下效
sxxz	施行細則
sxyc	稍遜一籌
sxyh	實習銀行
sxys	受降儀式
sxzc	什襲珍藏
sxzc	樗朽之材
sxzj	死相枕藉
sy	三樂
sy	什一
sy	似有
sy	俗樂
sy	匙鑰
syal	死於安樂
syb	誰也不
sybb	深淵薄冰
sybs	盛筵必散
syc	水蘊草
syc	漱玉詞
syd	水源地
syd	燒夷彈
syd	生有地
sydc	商業地產
sydd	山搖地動
sydz	深源地震
syeg	鎩羽而歸
syf	塞牙縫
syh	芍藥花
syjk	縮衣節口
syjs	縮衣節食
syjz	率由舊則
syjz	率由舊章
syl	使用率
syl	失業率
syl	市盈率
syl	收益率
sylz	隨緣樂助
symm	死也瞑目
symm	死亦瞑目
synl	莎喲娜拉
synz	盛筵難再
syp	什葉派
syqj	鼠牙雀角
syql	溯源窮流
syr	涮羊肉
syrh	似玉如花
sys	山有樞
sysc	水遠山長
sysj	舌咽神經
syss	殺衣縮食
sysx	時隱時見
sysz	吮癰舐痔
sysz	舐癰吮痔
sywc	率以爲常
syx	試運行
syxg	素隱行怪
syxg	索隱行怪
syy	水樣液
syyc	夙願以償
syyh	商業銀行
syys	山肴野蔌
syys	盛筵易散
syzl	什一之利
syzr	歲月崢嶸
syzx	食衣住行
syzyts	死有重於泰山
sz	三傳
sz	三藏
sz	上着
sz	使長
sz	侍從
szbe	守正不阿
szbx	事在必行
szbx	勢在必行
szbzmzs	守着鼻子抹着腮
szcg	水長船高
szcj	手足重繭
szd	所在地
szd	生長點
szdq	所在地區
szdy	失之東隅
szdz	稍長膽壯
szfs	三藏法師
szfs	掞藻飛聲
szfsz	三藏法師傳
szfy	生長發育
szg	三折肱
szg	十字鎬
szg	山楂糕
szgwly	三折肱爲良醫
szgx	絲竹管絃
szgx	駟之過隙
szhl	失之毫釐
szj	睡中覺
szjk	生殖健康
szjs	生長激素
szjsjx	三直角三角形
szjz	十捉九着
szl	生長輪
szl	睡着了
szl	鰓足類
szlc	神州陸沉
szll	實質利率
szpt	蘇州評彈
szq	生殖器
szq	生長期
szqb	三徵七辟
szqg	生殖器官
szqs	慎重其事
szrc	似醉如痴
szs	生長素
szsb	三戰三北
szst	守株伺兔
szsw	生張熟魏
szsy	損者三樂
sztc	蘇州彈詞
sztj	搜章擿句
sztq	隨珠彈雀
szts	死重泰山
szwr	三朝五日
szx	生殖腺
szx	神州行
szxs	矢在弦上
szy	水狀液
szy	絲竹樂
szyc	搔着癢處
szycd	十指有長短
szyz	生長因子
szz	首長制
szzd	四戰之地
t	㐁
t	㐌
t	㑷
t	㑽
t	㒉
ta	堤岸
tas	堤岸市
tb	佻薄
tb	停泊
tb	偷薄
tb	僮婢
tb	叨被
tbdc	徒步當車
tbdj	徒步當車
tbdl	天崩地裂
tbdlzxxt	臺北地理資訊系統
tbdt	天崩地塌
tbdx	吐哺待賢
tbe	彈布爾
tbh	唐伯虎
tbjymzx	臺北捷運木柵線
tbl	脫不了
tbl	逃不了
tblx	徒步旅行
tbpd	臺北盆地
tbqj	提不起勁
tbsy	探本溯源
tbsy	推本溯源
tbt	土伯特
tbwf	吐哺握髮
tbxzq	特別行政區
tbzf	吐哺捉髮
tbzz	同比增長
tc	同仇
tc	同儕
tc	同參
tc	唐朝
tc	圖讖
tcbyecb	頭醋不釅二醋薄
tcc	嗒笞笞
tcck	彈出窗口
tcdb	天差地別
tcdc	天愁地慘
tcdj	天長地久
tcdk	同仇敵愾
tcdl	天長地老
tcdt	天摧地塌
tcdy	天差地遠
tcdy	天長地遠
tcfd	淘澄飛跌
tcj	天長節
tcjs	調詞架訟
tcl	彈出來
tcl	頭朝裏
tcmz	偷饞抹嘴
tcrj	天長日久
tcs	搪差使
tcwc	挑茶斡刺
tcx	剔齒纖
tcx	郯城縣
tcyg	彈出一個
tcym	退藏於密
tczd	突出重點
tczz	舚脣咂嘴
td	停睇
td	儻蕩
td	同調
td	圖度
td	土地
tdbr	天地不容
tdcb	土地儲備
tdcb	土地承包
tdch	土地重劃
tdcr	土地出讓
tdd	拖地膽
tddd	天大地大
tddj	土地登記
tddy	通都大邑
tdf	土地法
tdg	土地公
tdgg	土地改革
tdgl	土地管理
tdgs	天地鬼神
tdgy	土地供應
tdgy	土地國有
tdgz	天地蓋載
tdh	天地會
tdhh	天道好還
tdj	天地間
tdj	拖地錦
tdjbl	貪多嚼不爛
tdjh	天地精華
tdjqs	天地君親師
tdjt	天地交泰
tdjx	棠棣競秀
tdkb	天地可表
tdkf	土地開發
tdlx	天地良心
tdly	土地利用
tdlyfp	土地老爺放屁
tdm	土地廟
tdmj	土地面積
tdp	土地婆
tds	土地稅
tdsc	土地市場
tdsj	天地世間
tdsyq	土地所有權
tdsyqz	土地所有權狀
tdt	天地頭
tdww	天地萬物
tdxh	天地玄黃
tdxt	土地信託
tdyh	土地銀行
tdys	天地一色
tdyso	天地一沙鷗
tdzb	天地之別
tdzg	踏地知根
tdzh	天地造化
tdzs	土地徵收
tdzy	土地資源
tdzzs	土地增值稅
te	太阿
te	忒惡
te	泰阿
te	覃恩
tedc	太阿倒持
tedc	泰阿倒持
teqjxq	土耳其進行曲
tezb	太阿之柄
tezw	太阿在握
tezx	鋌而走險
tf	吐蕃
tf	嚏噴
tf	土番
tf	土阜
tf	堤封
tfb	摶風板
tfbs	調風變俗
tfdf	天翻地覆
tfdz	天覆地載
tffy	摘伏發隱
tfgb	調幅廣播
tfl	薙髮令
tfny	調風弄月
tfscb	天發神讖碑
tftg	調風貼怪
tfy	土番鴨
tfy	調風月
tg	叨光
tg	帖括
tg	彈冠
tg	忒過
tg	恫瘝
tgcf	天官賜福
tgd	託管地
tgdd	天公地道
tgdh	天高地厚
tgdj	天冠地屨
tgdj	天高地迥
tgdk	天高地闊
tgdy	天高地遠
tgdz	天干地支
tgh	填溝壑
tghj	韜光晦跡
tghl	退耕還林
tghy	調弓號猿
tgjj	韜戈卷甲
tgjs	彈冠結綬
tgl	通過率
tgmj	韜光滅跡
tgpl	特高頻率
tgq	彈鋼琴
tgq	踏高蹻
tgsf	天官賜福
tgsf	韜光俟奮
tgwz	天乾物燥
tgxj	大羹玄酒
tgxl	提高效率
tgxq	彈冠相慶
tgy	帖括業
tgyd	同工異調
tgyd	銅管樂隊
tgyh	韜光養晦
tgyj	韜光隱跡
tgyq	銅管樂器
tgyw	韜戈偃武
tgyy	韜光韞玉
tgzb	恫瘝在抱
tgzs	恫瘝在身
tgzy	彈冠振衣
th	唾壺
th	嘽緩
th	團行
th	土行
th	填還
thbm	桃花薄命
thbzglz	跳虎撥着關捩子
thc	彈簧牀
thc	彈簧秤
thd	彈簧刀
thd	彈黃調
thda	天昏地暗
thdc	天昏地慘
thdd	天寒地凍
thdh	天昏地黑
thdl	天荒地老
thdn	調和鼎鼐
thds	韜晦待時
thg	彈簧鋼
thg	退還給
thgd	醍醐灌頂
thm	彈簧門
thq	彈劾權
thq	調合漆
ths	太行山
ths	抬行市
thssd	淌海水似的
thws	彈劾無私
thxj	同行相忌
thxsd	填海新生地
thy	同行業
thy	同行語
thy	苕華玉
thzd	填海造地
thzd	天花墜地
tj	兔罝
tj	叨教
tj	唾酒
tj	囤積
tj	囤聚
tjb	炭疽病
tjbkxl	天機不可泄漏
tjbzsbm	偷雞不着蝕把米
tjdj	天荊地棘
tjdt	統計地圖
tjdy	天經地義
tje	唾津兒
tjep	泰極而否
tjf	通緝犯
tjff	摘奸發伏
tjff	擿奸發伏
tjgl	彈斤估兩
tjgl	彈觔估兩
tjgm	兔角龜毛
tjhdz	唐吉訶德傳
tjhj	討價還價
tjhsp	泰極還生否
tjjq	囤積居奇
tjl	通緝令
tjm	堂姊妹
tjm	脫韁馬
tjs	忒敬思
tjsx	填街塞巷
tjsx	屯街塞巷
tjtl	銅筋鐵肋
tjwy	彈鋏無魚
tjxf	摶擊掀發
tjy	獺祭魚
tjzm	脫韁之馬
tjzr	頭角崢嶸
tjzr	頭角嶄然
tjzs	聽覺中樞
tk	帑廥
tk	帖括
tk	慟哭
tk	統括
tk	褪口
tkcs	饕口饞舌
tkdc	天剋地衝
tkfxy	太空飛行員
tkl	跳傀儡
tklsxc	提傀儡上戲場
tklt	慟哭流涕
tksz	彈空說嘴
tky	帖括業
tkyk	隄潰蟻孔
tl	佃獵
tl	停潦
tl	儻來
tl	叨攬
tl	叨濫
tlbc	螳螂捕蟬
tlbc	螳螂搏蟬
tldw	天羅地網
tldx	特立獨行
tldxh	鐵路地下化
tldy	天聾地啞
tlf	吐魯番
tlfwd	吐魯番窪地
tlh	同樂會
tljb	歎老嗟卑
tll	忒楞楞
tllt	忒楞楞騰
tlmpd	塔里木盆地
tlpw	泰來否往
tlq	螳螂拳
tlqm	田連仟佰
tls	調理室
tlxf	吐露心腹
tlz	捅婁子
tlzl	天倫之樂
tlzw	儻來之物
tlzz	停留長智
tm	他懣
tm	叨名
tm	吞沒
tm	唾沫
tm	唾罵
tmcz	通眉長爪
tmdb	兔毛大伯
tmdj	屠門大嚼
tmhx	鐵馬橫行
tmk	鐵門檻
tml	他們倆
tmld	脫帽露頂
tmnb	調墨弄筆
tmrc	貪冒榮寵
tms	天姥山
tmss	塗抹詩書
tmxk	天馬行空
tmxz	唾沫星子
tmy	忒沒意
tmzg	唾面自乾
tmzs	停眠整宿
tmzy	唾沫直嚥
tn	團掿
tn	忒恁
tn	摶搦
tn	汀濘
tn	調弄
tncg	屠牛朝歌
tndb	天南地北
tnjm	童牛角馬
tnqq	探囊胠篋
tnx	耵聹腺
tnxn	拖男挾女
tp	僮僕
tp	叨陪
tp	土坯
tp	天秤
tp	拓片
tpdd	調皮搗蛋
tpg	調皮鬼
tpgb	調頻廣播
tpp	彈琵琶
tpss	太平盛世
tpx	頭皮屑
tpxc	頭破血出
tpxl	頭破血流
tpxl	頭破血淋
tpy	討便宜
tpy	貪便宜
tpydp	天牌壓地牌
tpypd	太平洋盆地
tpyz	頭蓬眼瘇
tpz	天秤座
tpzc	綈袍之賜
tpzltsz	銅盆撞了鐵掃帚
tpzs	綈袍之賜
tq	叨竊
tq	唾棄
tq	天黥
tq	妥洽
tq	彈棋
tqbsx	圖窮匕首見
tqbx	圖窮匕見
tqc	同衾幬
tqch	褪前擦後
tqdg	天奇地怪
tqf	通緝犯
tqfj	兔起鳧舉
tqhd	提前還貸
tqhl	兔起鶻落
tqj	探親家
tqjz	頭輕腳重
tql	通緝令
tqmq	跳牆驀圈
tqyb	拖鎗拽棒
tqyegqx	聽其言而觀其行
tr	儻然
tr	儻若
tr	叨任
tr	叨擾
tr	忒恁
trjd	突然覺得
trmc	貪榮冒寵
trxw	天然纖維
ts	同宿
ts	唐塞
ts	唾手
ts	土參
ts	坦率
tsb	調色板
tsbq	吞聲屏氣
tsbrdl	天時不如地利
tsddz	唐山大地震
tsdlrh	天時地利人和
tsds	天授地設
tsds	天生地設
tsfyl	投手防禦率
tsj	鐵三角
tsjl	摶沙嚼蠟
tsjx	同時進行
tskd	唾手可得
tskq	唾手可取
tslg	摶砂煉汞
tsm	唾是命
tsmx	頭上抹下
tsng	摶砂弄汞
tsnj	韜聲匿跡
tsp	調色盤
tspz	彈絲品竹
tspz	調絲品竹
tstz	土生土長
tsws	調三斡四
tsws	調三窩四
tsws	貪生惡死
tswzef	螣蛇無足而飛
tsxx	荑手纖纖
tsz	唐三藏
tszf	摶沙作飯
tszh	摘山煮海
tszq	僮手指千
tszs	它山之石
tszz	童山濯濯
tt	佗佗
tt	佻達
tt	倜儻
tt	僮僮
tt	儃儃
ttbj	倜儻不羈
ttbq	倜儻不羣
ttc	透天厝
ttcd	通天徹地
ttdx	天塌地陷
ttfg	蜩螗沸羹
ttjd	跳天撅地
ttkd	啼天哭地
ttld	談天論地
ttlydjz	天塌了有地接着
ttmm	偷偷抹抹
ttmm	澹臺滅明
ttnn	推推攮攮
ttqd	推天搶地
ttql	迢迢千里
ttqq	拖拖棲棲
ttr	調停人
ttsd	拖天掃地
ttsd	談天說地
ttsd	譚天說地
ttsd	跳天索地
tttt	踢踢躂躂
ttw	踢躂舞
ttw	饕餮紋
ttxd	團體行動
ttxd	替天行道
tty	彈塗魚
ttzl	偷彈珠淚
ttzt	饕餮之徒
ttzz	堂堂之陳
tw	擿問
tw	痛惡
tw	袒免
tw	調味
tw	調溫
twdl	天文地理
twdq	臺灣地區
twj	同位角
twjczkxx	臺灣警察專科學校
twl	調味料
twp	調味品
twr	調味乳
twsz	推諉塞責
twydf	唐王遊地府
twyh	臺灣銀行
tx	同校
tx	吐血
tx	唾腺
tx	塌陷
tx	大學
txb	通行本
txdf	天下鼎沸
txdg	天懸地隔
txdz	天旋地轉
txf	通行費
txfj	彈性放假
txgs	彈性工時
txhy	特許行業
txhy	通信行業
txj	天行健
txl	貼現率
txlb	袒胸露背
txlc	袒裼裸裎
txms	彈性模數
txnf	摶香弄粉
txng	調絃弄管
txpf	彈性疲乏
txpy	貪小便宜
txpz	調絃品竹
txq	調諧器
txq	通行權
txs	土行孫
txs	投降書
txsb	彈性上班
txsn	彈性勢能
txsq	天行時氣
txw	天下危
txw	碳纖維
txw	銅臭味
txwz	通行無阻
txxd	彈性限度
txxn	推賢遜能
txxw	彈性纖維
txys	推賢樂善
txz	通行證
txzc	滕薛爭長
txzy	投降主義
txzzxt	彈性製造系統
ty	僮御
ty	兔躍
ty	唐樂
ty	唾液
ty	唾盂
tybs	跳躍比賽
tyc	太液池
tycg	鐵雲藏龜
tyd	太陽地
tydd	天搖地動
tydg	天遠地隔
tydj	天涯地角
tyh	吐谷渾
tyhj	天涯海角
tyj	拖曳機
tyjm	靦顏借命
tyml	淌眼抹淚
typd	糖衣炮彈
tys	拖曳傘
tysc	靦顏事仇
tysx	調養生息
tyx	唾液腺
tyx	桃源行
tyy	聽音樂
tyzc	天涯咫尺
tyzf	陶猗之富
tyzltd	桃園中壢臺地
tz	亭長
tz	吐屬
tz	團長
tz	土着
tz	土著
tzbcl	投資報酬率
tzcl	摶柱乘梁
tzcsj	匋齋藏石記
tzd	挑重擔
tzdb	天災地變
tzdh	天震地駭
tzdl	同軸電纜
tzdm	天誅地滅
tzdn	天災地孽
tzds	天造地設
tzdx	天真地秀
tzdx	天窄地狹
tzdz	天知地知
tzfsbrx	偷着浮生半日閒
tzgs	土長根生
tzh	苕之華
tzj	胎藏界
tzj	體重計
tzjq	頭重腳輕
tzl	偷着樂
tzl	腆着臉
tzmf	塗脂抹粉
tzmg	筒仔米糕
tzqs	土中曲蟮
tzsg	彈指神功
tzsq	頭重身輕
tzst	擿埴索塗
tztd	同志天地
tzts	調嘴調舌
tzxj	潭祉叶吉
tzxm	太子洗馬
tzy	同軸圓
tzyh	土質液化
tzyh	投資銀行
tzyl	推舟於陸
tzzj	叨在知己
tzzj	彈指之間
w	ㄨ
w	㐅
w	㐳
w	㑄
w	㒇
wa	違拗
wb	五伯
wb	五百
wb	五辟
wb	伍伯
wb	帷薄
wbbx	帷薄不修
wbl	忘不了
wbmj	烏白馬角
wbrdy	我不入地獄
wc	五畜
wc	五車
wc	倭遲
wc	吳澄
wc	吾儕
wcc	外長城
wcj	外錯角
wcnz	外弛內張
wcqq	爲叢敺雀
wcqy	無償契約
wcs	吳昌碩
wcs	魏長生
wct	味噌湯
wcwd	問長問短
wcx	外出血
wcxg	武城弦歌
wd	䰀鬌
wd	兀的
wd	危殆
wd	吳都
wd	唔篤
wdb	兀的不
wdc	吳大澂
wdd	挖地彈
wdfs	無的放矢
wdjghg	維德角共和國
wdjt	緯地經天
wdqd	五旦七調
wdr	外地人
wdwm	無適無莫
wdwz	誤打誤撞
wdym	舞刀躍馬
wdzc	無地自處
wdzdzbjf	五度制調值標記法
wdzr	無地自容
wdzz	歪打正着
we	惡惡
we	莞爾
webq	爲惡不悛
wecd	惡惡從短
wes	威爾遜
wfek	望風而潰
wfex	望風而降
wfma	物阜民安
wfmf	物阜民豐
wfmx	物阜民熙
wfpm	望風披靡
wfsx	微服私行
wftb	握髮吐哺
wfxw	違法行爲
wfzc	五方雜厝
wg	文蛤
wg	碗粿
wg	翁蛤
wgbs	煨乾避濕
wgcc	萬古長春
wgcq	萬古長青
wgdz	無感地震
wgfr	五穀豐稔
wgjs	偎乾就濕
wgjs	煨乾就濕
wgqd	萬剮千刀
wgtc	無鉤絛蟲
wgtg	王貢彈冠
wgtm	誤國殄民
wgwh	文攻武嚇
wgxw	違規行爲
wh	唔好
wh	外行
wh	威嚇
wh	媧皇
wh	往還
whaz	於呼哀哉
whbx	五行並下
whbz	五行八作
whcl	臥虎藏龍
whdy	文化底蘊
whh	外行話
whh	歪行貨
whhl	外匯匯率
whjx	五行俱下
whkrn	外行看熱鬧
whpd	渭河盆地
whr	外行人
why	往還於
whyh	外匯銀行
whz	五侯鯖
whzl	萬壑爭流
wj	䍪羯
wj	五車
wj	午覺
wj	味覺
wj	嗢噱
wjbg	甕盡杯乾
wjbl	挽救不了
wjbz	外交部長
wjc	五角場
wjcx	萬箭攢心
wjcx	違紀參選
wjdc	問卷調查
wjdc	無將大車
wjdj	無將大車
wjdl	五角大樓
wjdx	五角大廈
wjex	無脛而行
wjl	無噍類
wjlz	五角六張
wjnbc	魏晉南北朝
wjq	味覺器
wjq	外角球
wjrs	文姬入塞
wjsd	五經掃地
wjxm	蝸角虛名
wjxx	網際行銷
wjyt	蝸角蠅頭
wjyz	蝸居蟻蛭
wjz	屋脊爪
wjz	無盡藏
wjz	無給職
wjzz	蝸角之爭
wk	忨愒
wk	玩愒
wk	網咖
wkgn	無殼蝸牛
wkwn	無殼蝸牛
wky	窩瞘眼
wky	胃潰瘍
wl	壝埒
wl	外露
wl	完了
wl	我倆
wl	未了
wlb	斡離不
wlcc	萬里長城
wlft	物論沸騰
wlga	未了公案
wlhpd	烏梁海盆地
wlj	渦輪機
wlkf	網路咖啡
wlkfjlb	網路咖啡俱樂部
wlnl	頑廉懦立
wlpqfdj	渦輪噴氣發動機
wlq	未了情
wlsfq	網路伺服器
wltt	萬里迢迢
wlwx	無了無休
wlwz	武林外傳
wlxj	甕裏醯雞
wlxx	網路行銷
wlxxhd	網路行銷活動
wly	未了因
wly	未了緣
wlyh	網路銀行
wlyyt	網路音樂廳
wlzzd	無立足之地
wlzzd	無立錐之地
wm	偉懋
wm	嫵媚
wm	於穆
wm	洿沬
wm	濊貊
wmdj	望門大嚼
wmj	維摩詰
wmkk	萬目睽睽
wml	我們倆
wn	兀臬
wn	婠妠
wn	枉橈
wn	無那
wn	膃肭
wnb	溫尼伯
wnh	斡難河
wnq	膃肭臍
wnys	萬能鑰匙
wpc	外胚層
wpsz	無配生殖
wq	梧棲
wq	汪踦
wqbp	瓦器蚌盤
wqhq	握槧懷鉛
wqj	挖牆角
wqql	玩其磧礫
wqtz	握拳透爪
wqzg	外強中乾
wr	俇攘
wr	蚊蚋
wrjl	味如雞肋
wrks	玩日愒歲
wrsh	韋叡樹麾
wrszd	無容身之地
wrxs	爲人行事
wryh	無人銀行
wryl	巍然屹立
wrzd	無人之地
wrzl	危若朝露
ws	兀誰
ws	哇塞
ws	外宿
ws	威盛
ws	旺盛
wsd	瓦斯彈
wse	未熟兒
wsg	亡是公
wsg	文溯閣
wsh	五熟行
wsjx	惡濕居下
wskr	玩歲愒日
wsm	爲什麼
wsm	玩什麼
wss	我是誰
wssj	晚上睡覺
wswx	無聲無臭
wsyh	網上銀行
wszg	萬乘之國
wszl	爲善最樂
wszq	外生殖器
wszs	物盛則衰
wszz	萬乘之尊
wt	圩堤
wt	圩田
wt	婑媠
wt	微調
wt	於菟
wtcd	萬頭攢動
wtfm	無痛分娩
wth	委託行
wth	翁同龢
wthd	烏天黑地
wtjl	味同嚼蠟
wtjtx	無條件投降
wttd	五體投地
wtwl	文韜武略
wtwt	文韜武韜
wtxc	葦苕繫巢
ww	亹亹
ww	俇俇
ww	呱呱
ww	問遺
ww	喔喔
wwaa	窩窩凹凹
wwbj	亹亹不倦
wwbj	亹亹不卷
wwdd	呱呱墮地
wwyy	嗚嗚咽咽
wwzd	呱呱墜地
wwzj	毋忘在莒
wx	五行
wx	危行
wx	唔系
wx	外泄
wx	巫覡
wxbq	畏葸不前
wxds	衛星都市
wxdw	溫血動物
wxg	微血管
wxj	亡血家
wxkc	無隙可乘
wxq	無弦琴
wxqy	我行其野
wxsd	威信掃地
wxsz	五行四柱
wxsz	無性生殖
wxwnlr	無行爲能力人
wxws	我行我素
wxx	外行星
wxz	無行止
wxzz	無血戰爭
wy	五蘊
wy	伍員
wy	喔咿
wy	嗚咽
wy	嗚唈
wybs	伍員鞭屍
wycc	五言長城
wycc	伍員乘潮
wycgy	無煙囪工業
wycj	五一長假
wycm	未雨綢繆
wyd	王猷定
wyft	物議沸騰
wyjm	伍員抉目
wykl	文樂傀儡
wypq	五月披裘
wyqy	爲淵敺魚
wyre	喔咿嚅唲
wyss	甕牖桑樞
wyss	甕牖繩樞
wysz	無以塞責
wywj	畏影惡跡
wywx	危言危行
wywzd	無用武之地
wyz	委員長
wyzd	烏雲着頂
wyzz	汪洋自恣
wz	伍長
wz	唔知
wz	圩子
wz	外傳
wz	外長
wzb	尪仔標
wzbp	穩賺不賠
wzcz	惡直醜正
wzdy	韋陟朵雲
wzdz	惡紫奪朱
wzdz	網站地址
wzfb	妄自菲薄
wzglpdq	萬丈高樓平地起
wzhr	仵作行人
wzl	烏氏倮
wzpd	皖中盆地
wzqj	惡醉強酒
wzqz	未足輕重
wzqz	無足輕重
wzsz	位尊勢重
wztj	委重投艱
wzwd	穩紮穩打
wzyh	外資銀行
wzyqs	惡之欲其死
wzz	文謅謅
wzzd	無置錐地
wzzq	無足重輕
wzzy	舞爪張牙
x	㐨
x	㐩
x	㐫
x	㐮
x	㐰
xa	狹隘
xa	險隘
xadlsqd	小安地列斯羣島
xal	醯胺類
xb	儇薄
xb	削壁
xb	囂謗
xb	巷伯
xb	息賁
xbbz	行兵布陣
xbct	躧匾稱鉈
xbd	行不得
xbdf	西部地方
xbdq	西北地區
xbdq	西部地區
xbdygg	行不得也哥哥
xbex	信步而行
xbg	行必果
xbgh	行不苟合
xbgj	血不歸經
xbgm	行不改名
xbgm	行不更名
xbgr	行不苟容
xbgy	行不顧言
xbhdxyy	心病還得心藥醫
xbjy	行不及言
xbk	下巴頦
xbl	下不了
xbl	嚇不了
xbl	希伯來
xbl	西柏林
xblr	希伯來人
xbls	希伯來書
xblt	下不了臺
xbly	西伯利亞
xblyfqx	西伯利亞反氣旋
xblytl	西伯利亞鐵路
xblz	行兵列陣
xblzbyjs	行百里者半於九十
xbn	蕭伯納
xbq	心不愜
xbqw	挾冰求溫
xbrf	行步如風
xbrf	行步如飛
xbs	下半晌
xbs	小布什
xbsdf	刑不上大夫
xbt	行不通
xbtxw	性變態行爲
xbx	行不行
xbxf	弦不虛發
xbyf	行不踰方
xbyh	細胞銀行
xbyj	行不由徑
xbyw	纖不盈握
xbyyy	西班牙音樂
xbz	錫伯族
xbz	錫箔紙
xc	休屠
xc	信差
xc	修長
xc	削成
xc	削草
xcbh	秀出班行
xcbr	纖塵不染
xcbz	宣傳部長
xccl	行車距離
xcd	宣傳彈
xcfd	心長髮短
xcgl	懸車告老
xcgm	行成功滿
xcjl	行車距離
xckl	線抽傀儡
xcll	枵腸轆轆
xcp	畜產品
xcpp	心潮澎湃
xcs	斜長石
xcsl	行車速率
xct	小朝廷
xct	謝長廷
xctt	心奓體忕
xcxh	壎箎相和
xcyf	荀粲熨婦
xcys	行成於思
xcyy	鄉村音樂
xczj	夏蟲朝菌
xczn	懸車之年
xczs	小處着手
xczs	懸車致仕
xczt	尋村轉疃
xczz	行車執照
xd	下地
xd	下都
xd	凶地
xd	削地
xd	削奪
xdcg	行短才高
xdcq	行短才喬
xdd	涎瞪瞪
xdd	涎鄧鄧
xddd	心膽墮地
xddh	行動電話
xdds	現代都市
xdeqh	隙大而牆壞
xdez	席地而坐
xdf	下大夫
xdf	小地方
xdf	西都賦
xdgg	懸的過高
xdht	喜地歡天
xdj	行篤敬
xdjh	行動計劃
xdjx	西點軍校
xdkss	興都庫什山
xdl	新大陸
xdmt	席地幕天
xdp	行動派
xdqh	隙大牆壞
xds	行道樹
xds	許地山
xdsl	協定稅率
xdst	興都斯坦
xdtt	星點彈塗
xdx	向地性
xdxq	兄弟鬩牆
xdy	下地獄
xdy	行大運
xdyj	行動郵局
xdzr	行動自如
xdzw	行動坐臥
xe	娙娥
xe	巽二
xe	纖阿
xebn	謔而不虐
xeby	行而不遠
xembym	小兒麻痺疫苗
xembz	小兒麻痺症
xexy	響遏行雲
xezw	遐邇著聞
xf	下番
xf	削髮
xf	吁咈
xf	嘔咐
xf	囂浮
xfby	係風捕景
xfby	繫風捕景
xfcg	枵腹從公
xfcj	枵腹重趼
xfdc	星飛電掣
xfdy	吁咈都俞
xfex	相輔而行
xfg	西番果
xfgm	省方觀民
xfgs	省方觀俗
xfhx	翾風迴雪
xfjlsj	西方極樂世界
xfl	西番蓮
xfl	雪佛蘭
xfpz	削髮披緇
xfwc	學富五車
xfwj	學富五車
xfws	削髮爲僧
xfwy	削方爲圓
xfxy	腥風血雨
xfyl	吸風飲露
xfyx	曉伏夜行
xfz	小番子
xfzh	心腹重患
xg	娭光
xg	小紅
xg	弦歌
xg	弦高
xg	循陔
xgbc	弦歌不輟
xgcc	繡閣長春
xgfb	行個方便
xgfx	新股發行
xggg	畦溝灌溉
xgh	行寡悔
xgq	閒聒七
xgtp	心廣體胖
xgwy	削觚爲圓
xgys	挾貴倚勢
xh	下浣
xh	下澣
xh	下頜
xh	下頦
xh	呀豁
xhajsy	西海岸爵士樂
xhbd	雪花遍地
xhbsez	新罕布什爾州
xhd	信號彈
xhdd	巡航導彈
xhds	香火鼎盛
xhdw	嫌好道惡
xhfx	柙虎樊熊
xhh	笑呵呵
xhhz	協會會長
xhjd	行好積德
xhm	溴化鎂
xhn	溴化鈉
xhpl	析毫剖釐
xhqt	行合趨同
xhrs	行化如神
xhsm	喜歡什麼
xhsm	尋行數墨
xhw	溴化物
xhwy	谿壑無厭
xhxf	邂逅相逢
xhxky	消化性潰瘍
xhxx	巡迴學校
xhxy	邂逅相遇
xhy	消化液
xhy	溴化銀
xhys	烜赫一時
xhzd	尋行逐隊
xhzl	尋歡作樂
xhzx	頡頏之行
xhzy	邂逅之緣
xj	下勁
xj	于嗟
xj	修濬
xj	先覺
xj	先降
xjb	學籍簿
xjbl	形跡敗露
xjby	相驚伯有
xjby	纖芥不遺
xjc	行軍牀
xjc	許景澄
xjcg	熊經鴟顧
xjd	攜挾帶
xjds	心驚膽懾
xjdz	心驚膽懾
xjdz	心驚膽顫
xjdz	行軍動衆
xjg	斜角規
xjgl	懸車告老
xjgs	心肌梗塞
xjjf	現金給付
xjjm	行將就木
xjl	行酒令
xjmq	行奸賣俏
xjmy	細嚼慢嚥
xjpz	陷堅破陣
xjq	嗅覺器
xjq	行經期
xjrc	心驚肉顫
xjrf	心焦如火
xjrf	行疾如飛
xjrz	心驚肉顫
xjs	行腳僧
xjsq	虛憍恃氣
xjsy	新爵士樂
xjwl	醯雞甕裏
xjxs	相機行事
xjxz	先覺先知
xjy	徐繼畬
xjyc	行己有恥
xjyf	行己有方
xjyn	香嬌玉嫩
xjys	修謹以俟
xjyy	心旌搖曳
xjzn	懸車之年
xjzs	懸車致仕
xjzs	行監坐守
xk	挾纊
xk	晞堁
xk	校刊
xk	狎客
xk	獝狂
xkcr	蟹匡蟬緌
xkmq	行虧名缺
xktp	心寬體胖
xkz	行看子
xl	享樂
xl	先零
xl	喜樂
xl	尋樂
xl	屧廊
xlb	小老闆
xlbj	西泠八家
xlc	偰列箎
xlcd	笑裏藏刀
xld	行李袋
xlfh	降龍伏虎
xlfs	泄漏風聲
xlg	效率高
xlgg	心膂股肱
xljd	訓練基地
xlk	小倆口
xll	響泠泠
xlmz	仙露明珠
xln	行路難
xlq	西泠橋
xlsd	西拉山地
xlsz	西泠十子
xlt	行樂圖
xltj	泄漏天機
xltj	顯露頭角
xltjq	心律調節器
xlx	行李箱
xlxp	涎臉涎皮
xlxq	踅來踅去
xlyl	新浪娛樂
xlyx	顯露原形
xlyy	心靈音樂
xlzy	享樂主義
xlzy	心膂爪牙
xm	削麪
xm	囟門
xm	媟慢
xm	廈門
xm	泄密
xmb	弦面板
xmc	纖毛蟲
xmct	形名參同
xmcx	撏綿扯絮
xmd	西門町
xmdb	撏毛搗鬢
xmdj	消滅殆盡
xmdx	廈門大學
xmgc	行滿功成
xmgy	行滿功圓
xmjs	循名校實
xmld	行眠立盹
xmlh	踅門瞭戶
xms	廈門市
xmss	夏目漱石
xmsy	畜牧獸醫
xmtb	玄祕塔碑
xmwl	削木爲吏
xmx	畜牧學
xmx	西蒙遜
xmy	畜牧業
xmyd	纖毛運動
xmyj	信馬游韁
xmz	夏丏尊
xmz	蕁麻疹
xmzbtg	新沐者必彈冠
xmzxxlz	小馬乍行嫌路窄
xn	囂鬧
xn	媟弄
xn	嬛佞
xn	憸佞
xn	狎弄
xnal	喜怒哀樂
xndq	西南地區
xnft	雪虐風饕
xnhz	雪泥鴻爪
xnj	犀牛角
xnkl	新年快樂
xnz	小年朝
xnzd	纖穠中度
xp	下聘
xp	刑辟
xp	小弁
xp	旋辟
xp	獻曝
xpbm	賢否不明
xpll	涎皮賴臉
xpsd	挾朋樹黨
xpt	小扒頭
xpt	須菩堤
xpy	小便宜
xpz	線坯子
xq	休憩
xq	修葺
xq	削球
xq	協緝
xq	吁氣
xqby	息黥補劓
xqj	弦切角
xqld	行權立斷
xqlx	揎拳捋袖
xqlx	揎拳擄袖
xqys	挾權倚勢
xqzc	相去咫尺
xqzh	鬩牆之禍
xqzk	旋乾轉坤
xr	削弱
xr	囂然
xr	孅弱
xr	小稔
xr	岈然
xrcqq	小人長戚戚
xrcyd	行人穿越道
xrdj	心如刀攪
xrgz	行若狗彘
xrjj	陷入絕境
xrk	陷人坑
xrnsxz	學如逆水行舟
xrq	行人情
xrt	信人調
xrtbq	行人徒步區
xrws	行若無事
xryq	泫然欲泣
xrzj	挾人捉將
xrzl	欣然自樂
xs	下乘
xs	信宿
xs	削瘦
xs	削色
xs	勗率
xsb	峴山碑
xsb	見世報
xsbf	悉索薄賦
xsc	相似詞
xsc	蟋蟀草
xscc	心事重重
xscc	行色匆匆
xsch	挾山超海
xscl	細水長流
xsd	新生地
xsdbx	相似多邊形
xsdc	刑事調查
xsdh	虛聲恫嚇
xsdz	行師動衆
xsgf	省俗觀風
xsh	香水行
xshs	先盛後衰
xsj	下死勁
xsj	小乘戒
xsjx	學生進行
xsjz	學生家長
xskl	懸絲傀儡
xsl	挾書律
xsl	行事曆
xsl	西塞羅
xsll	小時了了
xsm	些什麼
xsm	學什麼
xsm	想什麼
xsmt	蠨蛸滿堂
xsnq	挾勢弄權
xsrb	西山日薄
xssq	行隨事遷
xssr	行屍視肉
xsss	學生宿舍
xstlbt	希斯汀禮拜堂
xsws	欣生惡死
xsws	行所無事
xsx	相似形
xsx	相似性
xsyf	小山樂府
xsyyz	醒世姻緣傳
xsz	硤石鎮
xsz	胸廝撞
xsz	行駛證
xszc	相似之處
xszg	行尸走骨
xszr	行尸走肉
xszr	行屍走肉
xszw	行三坐五
xszx	行思坐想
xszy	行思坐憶
xt	下調
xt	休屠
xt	協調
xt	喧闐
xt	噱頭
xtd	小天地
xtd	戲提調
xtd	新天地
xtdn	蹊田奪牛
xtfz	協調發展
xtgx	行同狗豨
xtgz	行同狗彘
xth	須陀洹
xthx	巽他海峽
xthy	系統還原
xtjd	掀天揭地
xtjz	協調機制
xtlt	孝弟力田
xtqd	巽他羣島
xtqx	先天缺陷
xtrn	削鐵如泥
xtscbh	挾泰山超北海
xtwd	掀天斡地
xtx	協調性
xtxd	謝天謝地
xtxjx	先天性畸形
xtxlzgbz	心頭小鹿撞個不住
xtzxl	心頭撞小鹿
xtzylzh	挾天子以令諸侯
xtzzm	挾天子之命
xw	媟污
xw	嫌惡
xw	弦紋
xw	弦韋
xw	旋渦
xwb	纖維板
xwbj	洽聞博見
xwdb	纖維蛋白
xwdby	纖維蛋白原
xwgf	行爲規範
xwgx	纖維光學
xwgy	纖維工業
xwj	纖維鏡
xwjx	校外教學
xwkx	行爲科學
xwlj	喜聞樂見
xwll	行萬里路
xwlzzd	下無立錐之地
xwms	行爲模式
xwnl	行爲能力
xwp	行爲派
xwqj	洽聞強記
xwqs	謏聞淺說
xwr	行爲人
xws	纖維素
xwsfd	響尾蛇飛彈
xwsw	胸無宿物
xwxb	纖維細胞
xwxt	臭味相投
xwxy	漩渦星雲
xwys	行無越思
xwys	行爲藝術
xwysz	行爲藝術者
xwyyy	夏威夷音樂
xwyz	箱網養殖
xwz	余吾鎮
xwzb	先吾着鞭
xwzl	謏聞之陋
xwzw	纖維植物
xwzx	羞惡之心
xwzy	弦外之意
xwzy	弦外之音
xwzy	行爲主義
xwzz	行爲準則
xx	下弦
xx	下行
xx	下陷
xx	余余
xx	俔俔
xxbl	兇相畢露
xxc	吸血蟲
xxc	行刑場
xxcz	小隙沉舟
xxdd	涎涎鄧鄧
xxdz	馨香禱祝
xxex	相須而行
xxf	現行法
xxf	現行犯
xxf	行星風
xxfz	蕭行范篆
xxg	先行官
xxg	吸血鬼
xxgg	洗削更革
xxgg	絮絮聒聒
xxh	星宿海
xxh	纖細畫
xxhh	行行忽忽
xxhw	先行後聞
xxj	弦心距
xxj	續弦膠
xxjc	相形見絀
xxjnr	行憲紀念日
xxjy	學校教育
xxkj	孝行可嘉
xxl	新血輪
xxl	響屧廊
xxld	心懸兩地
xxls	西鄉隆盛
xxls	鴞心鸝舌
xxnc	挾細拿粗
xxpf	孝先便腹
xxpl	信息披露
xxqy	欣喜雀躍
xxrz	纖纖弱質
xxss	嘻嘻嗄嗄
xxw	下行文
xxw	性行爲
xxwy	纖悉無遺
xxwz	蟹行文字
xxx	下行星
xxx	小行星
xxx	行銷學
xxxr	相呴相濡
xxxx	伈伈睍睍
xxy	行星儀
xxy	顯像液
xxyg	星行夜歸
xxyl	休閒娛樂
xxys	曉行夜宿
xxys	纖纖玉手
xxz	先行者
xxz	吸血蛭
xxzb	膝行肘步
xxzgr	修行在個人
xxzxy	行星狀星雲
xxzz	蠍蠍螫螫
xy	下咽
xy	仙樂
xy	吁俞
xy	向隅
xy	吸菸
xybp	小眼薄皮
xybw	喜躍抃舞
xycc	隰有萇楚
xycy	閒言長語
xydq	向隅獨泣
xydy	硝煙彈雨
xyeq	向隅而泣
xyfd	巡弋飛彈
xygs	衒玉賈石
xyh	校友會
xyhl	先憂後樂
xyhx	瑕瑜互見
xyj	懸液劑
xykm	析疑匡謬
xykw	羞與噲伍
xylc	心餘力絀
xyll	校園倫理
xyls	行雲流水
xymg	校園民歌
xynz	心癢難撾
xypp	洶湧澎湃
xyq	弦樂器
xyqh	胸有丘壑
xyqz	行以求知
xys	小衣裳
xys	西洋參
xysm	需要什麼
xyt	信樂團
xywl	校園網路
xywq	相倚爲彊
xywy	虛與委蛇
xyx	滎陽縣
xyxy	涎言涎語
xyyh	興業銀行
xyyl	行有餘力
xyyz	學院院長
xyze	行遠自邇
xyzy	行吟坐詠
xyzy	行雨朝雲
xz	下着
xz	儇子
xz	兄長
xz	削正
xz	削着
xzb	小宗伯
xzb	行政部
xzba	行坐不安
xzbd	見鐘不打
xzbm	行政部門
xzbx	行針步線
xzbx	行鍼布線
xzby	行之不遠
xzc	行政村
xzcf	行政處分
xzcf	行政處罰
xzch	下自成行
xzcl	懸針垂露
xzclq	行政裁量權
xzcx	下自成蹊
xzd	溴中毒
xzdf	西藏地方
xzdl	下知地理
xzdp	席珍待聘
xzdz	下載地址
xzf	行政法
xzf	行政犯
xzf	見在佛
xzfg	行政法規
xzfj	西藏佛教
xzfy	行政法院
xzfy	行政複議
xzg	行政官
xzgl	行政管理
xzgs	行政官署
xzh	瞎扎呼
xzjc	行政警察
xzjd	行政監督
xzjg	行政機關
xzjj	行政救濟
xzjl	削足就履
xzlf	行政立法
xzlh	幸災樂禍
xzlx	現在流行
xzmb	心臟麻痺
xzml	行政命令
xzmz	先怎麼栽
xzph	行蹤飄忽
xzq	行政區
xzq	行政權
xzqh	行政區劃
xzqh	行政區畫
xzqj	孝重千斤
xzqk	旋轉乾坤
xzql	行政權力
xzqy	行政區域
xzrf	行走如飛
xzs	性知識
xzsdehs	陷之死地而後生
xzsf	行政司法
xzsj	削趾適屨
xzsl	削足適履
xzsm	遜志時敏
xzsp	行政審批
xzss	行政訴訟
xzstjwyh	鄉鎮市調解委員會
xzsy	行政事業
xzsy	行政訴願
xzwd	行蹤無定
xzwj	行之惟艱
xzwq	徙宅忘妻
xzx	行政學
xzxh	血債血還
xzxj	先知先覺
xzxk	行政許可
xzxl	挾主行令
xzxl	行政效率
xzxm	兇終隙末
xzxt	行政協調
xzxw	行政行爲
xzy	修正液
xzy	懸濁液
xzy	蕈狀雲
xzy	行政院
xzydlwyh	行政院大陸委員會
xzyhaxfs	行政院海岸巡防署
xzyhbs	行政院環保署
xzyhy	行政院會議
xzykjwyh	行政院客家委員會
xzylgwyh	行政院勞工委員會
xzynywyh	行政院農業委員會
xzyq	行濁言清
xzyqfh	行政院青輔會
xzyqwwyh	行政院僑務委員會
xzyrsxzj	行政院人事行政局
xzytywyh	行政院體育委員會
xzywss	行政院衛生署
xzyx	行之有效
xzyxwj	行政院新聞局
xzyzjc	行政院主計處
xzz	樨枳子
xzzf	行政執法
xzzg	行政主管
xzzg	行政長官
xzzl	行政中立
xzzx	行鍼走線
y	ㄧ
y	ㄩ
y	㐆
y	㐖
y	㐯
ya	乂安
ya	唈僾
ya	獄犴
ya	獄豻
ya	艾安
yb	倚薄
yb	厭薄
yb	咽哺
yb	員弁
yb	姻伯
ybc	油碧幢
ybdc	樣本調查
ybesh	一百二十行
ybex	鴨步鵝行
ybgx	言不顧行
ybhyb	一報還一報
ybjx	言不踐行
ybkc	欲不可從
ybkz	欲不可從
ybl	用不了
yblh	亞伯拉罕
yblncqjh	也不攬那磁器傢伙
ybmd	一筆抹倒
ybms	一筆抹殺
ybms	一筆抹煞
ybnz	一不拗衆
ybrb	飲冰茹蘗
ybsb	飲冰食蘗
ybss	弋不射宿
ybtd	一敗塗地
ybxc	鷸蚌相持
ybxz	鷸蚌相爭
yby	搖擺樂
ybyd	衣不曳地
ybyt	義薄雲天
ybz	用不着
ybzb	衣不重帛
ybzc	衣不重采
yc	一轍
yc	一長
yc	也曾
yc	余車
yc	儀從
ycbc	有仇報仇
ycbd	揚長避短
ycbx	言出必行
ycc	玉參差
ycc	陰沈沈
yccc	衣裳楚楚
ycd	原產地
ycdf	陰曹地府
ycdzms	原產地證明書
yce	魚朝恩
yced	一長二短
yceq	揚長而去
ychtsc	一尺還他十寸
ycj	魚藏劍
ycjd	尉遲敬德
ycjh	延長記號
ycjk	一觸即潰
ycjx	言從計行
ycld	一長兩短
ycld	議長論短
ycll	言詞泠泠
ycly	瑤池閬苑
ycmd	夜長夢多
ycn	一剎那
ycp	鹽藏品
ycqy	有償契約
ycs	延長賽
ycs	月長石
ycsxcc	有尺水行尺船
ycsy	一償宿願
yctx	右側通行
yctzycc	一朝天子一朝臣
ycx	延長線
ycxw	有償行爲
ycxw	異常行爲
ycyd	一長一短
ycyh	景從雲合
ycyj	景從雲集
ycys	尉遲乙僧
ycyy	瑤池玉液
ycyy	魚沈雁杳
ycyz	一衝一撞
ycyz	一酬一酢
ycz	樣冊子
yczd	盈尺之地
yczh	衣裳之會
yd	一地
yd	佣鈿
yd	傴兜
yd	原地
yd	右地
ydap	樂道安貧
ydc	優地槽
ydc	有多長
ydcj	運動錯覺
ydcy	遠渡重洋
ydcz	韞櫝藏珠
ydd	屹蹬蹬
ydec	韞櫝而藏
ydfs	有的放矢
ydgj	輿地廣記
ydh	洋地黃
ydhn	一地胡拿
ydhsmwg	約旦哈什米王國
ydj	影調劇
ydj	軋道機
ydjb	一代巨擘
ydjt	咬釘嚼鐵
ydl	一地裏
ydl	一點露
ydl	延地裏
ydl	遙地裏
ydmpjc	陰道抹片檢查
ydmygcr	一石米養個仇人
ydpd	洋底盆地
ydq	永佃權
ydrsh	硬打軟熟和
yds	一簞食
yds	菸斗絲
ydsx	言多傷行
ydtb	原地踏步
ydwq	野調無腔
ydx	羊肚蕈
ydxf	異地相逢
ydy	俞大猷
ydyj	月地雲階
ydyq	移調樂器
ydz	咽刀子
ydz	用得着
ydz	輿地志
ydzmx	鹽打怎麼鹹
ydzsc	也得蒸熟喫
ydzsy	一度着蛇咬
ydzw	陰地植物
ydzx	有道則見
ydzy	因地制宜
ye	吟哦
ye	夭閼
ye	淤閼
ye	湮阨
ye	迎阿
yedd	元惡大憝
yelk	依阿兩可
yemn	鬻兒賣女
yeqr	依阿取容
yeswl	嬰兒死亡率
yf	一番
yf	傴拊
yf	圜扉
yf	徼福
yf	押番
yfcl	飲風餐露
yfcy	越鳧楚乙
yfcz	懿範長昭
yfcz	鶯飛草長
yfdd	鹽分地帶
yfh	一番話
yfhq	一分行情
yfkl	藥發傀儡
yfks	一番口舌
yfl	演繁露
yflg	揚幡擂鼓
yflj	煙霏露結
yflt	鳶飛戾天
yfs	樂府詩
yfsj	樂府詩集
yfstb	一飯三吐哺
yfxz	依法行政
yfyy	迎風搖曳
yfyy	鳶飛魚躍
yfyz	院副院長
yfzh	揚幡招魂
yfzl	于飛之樂
yfzl	樂府雜錄
yfzm	樂府指迷
yfzx	一傅衆咻
yg	射干
yg	斜谷
yg	有哏
yg	樂工
yg	樂歌
ygd	曳光彈
ygddzlxq	有個地洞鑽了下去
ygdz	有感地震
ygej	一乾二淨
ygex	魚貫而行
yggyzd	一個個要着地
yghl	葉公好龍
ygj	一個勁
ygj	有感覺
yglfx	豔歌羅敷行
yglgd	一個獵古調
ygly	衣冠禮樂
ygmj	鬻官賣爵
ygms	一概抹殺
ygq	洋乾漆
ygq	顏杲卿
ygqd	異國情調
ygsd	有鬼似的
ygss	衣冠盛事
ygtc	有鉤絛蟲
ygtx	彥國吐屑
ygwnlzc	一個碗內兩張匙
ygwt	以規爲瑱
ygx	燕歌行
ygxs	因公行私
ygy	搖滾樂
ygyzx	一摑一掌血
ygz	隱睪症
ygzx	嚴格執行
ygzz	言歸正傳
yh	一笏
yh	以還
yh	依還
yh	咽喉
yh	央行
yhb	煙花簿
yhck	銀行存款
yhcs	一麾出守
yhcs	浴火重生
yhdk	銀行貸款
yhdq	沿海地區
yhdzd	銀行對帳單
yhfr	羽翮飛肉
yhg	菸灰缸
yhg	銀行股
yhgg	引吭高歌
yhj	軋花機
yhj	銀行家
yhj	銀行間
yhjjb	雲麾將軍碑
yhjl	油花伎倆
yhk	銀行卡
yhklsdf	約翰·克利斯多夫
yhlhgxr	銀行利害關係人
yhnb	欲壑難飽
yhnt	慾壑難填
yhnt	欲壑難填
yhq	銀行券
yhs	呦嚄說
yhsjx	楊輝三角形
yhslhs	一回生兩回熟
yhsm	一行三昧
yhsyq	液化石油氣
yht	銀行團
yhtrq	液化天然氣
yhtxzj	銀行體系資金
yhtz	咬合調整
yhws	有行無市
yhws	液化瓦斯
yhx	野狐涎
yhxz	雲麾勛章
yhy	銀行業
yhyb	一還一報
yhyj	羽翮已就
yhyl	咽喉要路
yhzh	銀行賬戶
yhzy	一狐之腋
yhzy	雁行折翼
yj	一覺
yj	仰給
yj	仰角
yj	余車
yj	傭給
yja	羊角哀
yjbg	雲譎波詭
yjbyy	洋涇浜英語
yjc	液晶窗
yjcd	一較長短
yjcm	隱跡藏名
yjcx	隱介藏形
yjd	一腳地
yjd	鹽鹼地
yjdr	以己度人
yjdz	郵件地址
yjf	羊角風
yjg	一攪果
yjgc	夜靜更長
yjhj	要價還價
yjht	欲就還推
yjhx	蘊藉含蓄
yjhx	衣錦還鄉
yjlc	揚己露才
yjld	研京練都
yjm	眼角膜
yjmx	遺精夢泄
yjnfhl	越雞難伏鵠卵
yjp	瑜伽派
yjs	楊繼盛
yjs	羊胛熟
yjs	菸酒稅
yjs	菸鹼酸
yjsdl	瑜伽師地論
yjsjz	粵江三角洲
yjta	研精覃奧
yjts	研精覃思
yjtyq	液晶投影器
yjwg	遊騎無歸
yjwm	曳裾王門
yjx	滎經縣
yjxp	瑜伽行派
yjxs	依計行事
yjxsq	液晶顯示器
yjyd	雲階月地
yjyg	言簡意賅
yjyh	有借有還
yjyl	寓教於樂
yjyr	仰給於人
yjyx	衣錦夜行
yjz	壓角章
yjz	有給職
yjz	瑜伽宗
yjzc	一技之長
yjzc	一箭之仇
yjzd	一箭之地
yjzd	郵寄炸彈
yjze	陽九之阨
yjzg	搖囝仔歌
yjzl	飲酒作樂
yjzxdrzx	以己之心度人之心
yjzz	業績增長
yjzztds	眼睛長在頭頂上
yk	窳楛
yk	菀枯
yk	蟻潰
yk	陰鏗
yk	隱括
ykfz	葉塊繁殖
yklc	一口兩匙
ykns	魚潰鳥散
ykstlld	一塊石頭落了地
ykww	與噲爲伍
ykwx	有口無行
yl	一了
yl	一怔
yl	仡栗
yl	佚樂
yl	傴僂
ylbd	一了百當
ylbg	娛樂八卦
ylbl	一了百了
ylby	屹立不搖
ylbz	一鱗半爪
ylc	源賴朝
ylc	遊樂場
ylcf	飲露餐風
ylcs	娛樂場所
yldd	永樂大典
ylf	引路幡
ylg	亞硫酐
ylg	永樂宮
ylh	曳落河
ylhd	娛樂活動
ylj	娛樂界
ylj	掩咯雞
ylj	軋路機
ylj	鴨綠江
yljf	醫療給付
yljm	娛樂節目
yll	月利率
yll	遊樂林
ylp	娛樂片
ylq	娛樂圈
ylq	永樂錢
yls	娛樂稅
ylsbsd	伊麗莎白時代
ylsbys	伊麗莎白一世
ylsd	遊覽勝地
ylsh	月落參橫
ylsy	沿流溯源
ylwh	以鄰爲壑
ylx	娛樂性
ylx	尉犁縣
ylx	魚鱗癬
ylxdpz	陰了信的炮𤍤
ylxw	娛樂新聞
ylxy	一了心願
yly	娛樂業
yly	永樂窯
yly	遊樂園
ylyd	彝倫攸斁
ylyh	一釐一毫
ylyj	有棱有角
ylyx	煙嵐雲岫
ylzbj	雅魯藏布江
ylze	雨露之恩
ylzj	羊陸之交
ym	一抹
ym	咽門
ym	壓蔓
ym	央浼
ym	嫈嫇
ymbs	一瞑不視
ymc	葉名琛
ymcckx	飲馬長城窟行
ymch	游目騁懷
ymd	煙幕彈
ymdc	葉面對稱
ymdf	幽冥地府
ymdz	榆瞑豆重
ymfc	殷民阜財
ymfl	殷民阜利
ymg	也麼哥
ymj	顏面角
ymlr	一目了然
yms	元祕史
ymsfd	一畝三分地
ymsh	一目十行
ymtl	與民同樂
ymws	有名亡實
ymww	湮沒無聞
ymx	一滅行
ymxc	幺麼小醜
ymxl	與民偕樂
ymyb	躍馬揚鞭
ymyg	央浼營幹
ymyy	一模一樣
ymz	有模子
ymzz	揚眉抵掌
ymzz	揠苗助長
yn	一捻
yn	夭娜
yn	愚懦
yn	拗怒
yn	爺孃
ynh	一捻紅
ynhd	一牛吼地
ynhx	雲南黃馨
ynnq	越鳥南棲
ynsh	葉尼塞河
ynz	藥捻子
yp	偃仆
yp	延聘
yp	應聘
yp	懿濞
yp	椅披
ypg	菸屁股
ypm	液泡膜
yps	優婆塞
ypsh	一暴十寒
ypsh	一曝十寒
ypsz	異配生殖
ypxky	壓迫性潰瘍
ypzz	揚葩振藻
yq	乙炔
yq	依棲
yq	優洽
yq	允洽
yq	咽氣
yqazhhz	燕雀安知鴻鵠志
yqblxkd	一錢不落虛空地
yqd	油氣彈
yqdj	蘊奇待價
yqfq	緣慳分淺
yqgzz	眼球乾燥症
yqhc	一氣呵成
yqhd	油腔滑調
yqhw	鷹覷鶻望
yqjgj	一鍬掘個井
yqjz	牙籤錦軸
yqmj	緣慳命蹇
yqnh	搖旗吶喊
yqqzhhz	燕雀豈知鴻鵠志
yqsc	用其所長
yqsz	義氣深重
yqwz	牙籤萬軸
yqxz	牙簽犀軸
yqxz	言清行濁
yqyg	幽棲巖谷
yqyh	一丘一壑
yqyz	牙籤玉軸
yqzh	一丘之貉
yqzx	踰牆鑽隙
yr	一稔
yr	妖嬈
yr	屹然
yr	樂人
yr	殷然
yrbcc	羊肉不曾喫
yrce	褎如充耳
yrjs	褎然舉首
yrq	閻若璩
yrsj	易如拾芥
yrxp	野人獻曝
yrz	印人傳
yrz	艾如張
yrzl	怡然自樂
yrzs	躍然紙上
yrzt	纓緌之徒
ys	一似
ys	一晌
ys	于思
ys	嗌塞
ys	圓熟
ysbh	一樹百穫
ysbj	饔飧不給
ysbk	一聲不吭
ysbr	亞塞拜然
ysbrghg	亞塞拜然共和國
yscc	與世長辭
ysczbj	一生喫着不盡
ysczc	游僧攢住持
ysdf	御史大夫
ysf	嚴世蕃
ysfd	鷹式飛彈
ysft	雨順風調
ysfx	仰事俯畜
ysfx	永矢弗諼
ysgj	羽扇綸巾
ysh	堰塞湖
ysh	耶穌會
yshx	欲說還休
ysj	右上角
ysj	耶穌教
ysjbljh	遠水救不了近火
ysjd	耶穌基督
ysl	洋商陸
ysl	葉盛蘭
yslc	源深流長
ysld	以升量石
ysll	抑塞磊落
yslz	一死了之
ysm	用什麼
ysmx	煙視媚行
yspy	野叟曝言
ysq	鑰匙圈
ysqg	飲水曲肱
ystj	研深覃精
ystx	譽塞天下
ysxc	用舍行藏
ysxh	欲深谿壑
ysxq	倚勢挾權
ysxx	夜宿曉行
ysxx	玉手纖纖
ysys	樂山樂水
ysys	陰盛陽衰
ysyz	一弛一張
ysyz	刈蓍遺簪
ysz	銀揲子
yszd	一矢之地
yszd	有誰知道
yszkzzl	應收帳款週轉率
yszx	衣食住行
yszx	餘食贅行
yt	于闐
yt	咽唾
yt	咽頭
yt	嚥唾
yt	圩堤
ytbzj	液體比重計
ytcl	遠圖長慮
ytct	仰天長歎
ytcz	魚頭參政
ytd	詠嘆調
ytdd	殷天動地
ytdq	亞太地區
ytgj	蠅頭蝸角
ytjx	言聽計行
ytqd	冤天屈地
ytrlhjfdj	液體燃料火箭發動機
ytry	液態溶液
ytwf	以湯沃沸
ytwj	蠅頭蝸角
ytws	液體瓦斯
ytxc	言聽行從
ytxs	言談行事
yty	咽頭炎
yty	液態氧
ytyd	怨天怨地
ytyd	用天因地
ytz	一彈指
ytzd	殷天震地
ytzdnq	一頭撞倒南牆
ytzf	以湯止沸
ytzf	揚湯止沸
ytzlz	雁頭鴟勞嘴
ytzs	一頭撞死
ytzz	以莛撞鐘
yw	厭惡
yw	咿唔
yw	咿喔
yw	樂翁
yw	樂舞
ywcl	越王嘗蓼
ywcz	喑嗚叱吒
ywcz	喑噁叱吒
ywcz	喑惡叱吒
ywj	宇文覺
ywjz	咬文嚼字
ywnt	曳尾泥塗
ywpd	夷爲平地
ywsc	一無所長
ywsc	意味深長
ywtz	曳尾塗中
ywxyw	一物降一物
ywyppmg	閻王也怕拚命鬼
ywzd	用武之地
ywzs	仰屋著書
ywzw	一無長物
ywzz	以微知著
yx	一宿
yx	也行
yx	優洽
yx	允洽
yx	印行
yxbl	原形畢露
yxc	羊栖菜
yxc	羊鬚瘡
yxc	野莧菜
yxcb	憂喜參半
yxcb	疑信參半
yxcj	掩瑕藏疾
yxcm	游心騁目
yxcx	以血償血
yxd	一席地
yxdl	餘弦定律
yxdz	郵箱地址
yxer	眼餳耳熱
yxfc	羽檄飛馳
yxfz	有性繁殖
yxgs	猿穴壞山
yxhz	月夕花朝
yxj	右下角
yxj	圓心角
yxj	夜行軍
yxjc	羽檄交馳
yxjc	言行計從
yxjz	言行舉止
yxjz	運行機制
yxkc	有隙可乘
yxkf	義行可風
yxl	言行錄
yxm	楊行密
yxq	一弦琴
yxqk	運行情況
yxr	一行人
yxr	夜行人
yxrt	憂心如惔
yxry	言行若一
yxs	玉谿生
yxsc	用行舍藏
yxsd	豫西山地
yxsd	運行速度
yxsq	禹行舜趨
yxsys	乙醯水楊酸
yxsz	有性生殖
yxt	一踅頭
yxtx	淫心慝行
yxwc	疑行無成
yxwm	疑行無名
yxwywzd	英雄無用武之地
yxx	噫吁戲
yxxb	言行相悖
yxxg	言行相詭
yxxg	言行相顧
yxxt	語笑喧闐
yxy	夜行衣
yxys	雲行雨施
yxyx	衣繡夜行
yxyy	應弦飲羽
yxyz	言行一致
yxzd	一席之地
yxzf	夜行晝伏
yxzl	一行作吏
yxzx	幼學壯行
yxzx	衣繡晝行
yy	一隅
yy	仡仡
yy	傴傴
yy	冘冘
yy	冘豫
yyb	姻緣簿
yybf	音樂播放
yybfd	義勇兵飛彈
yybl	怏怏不樂
yybl	悒悒不樂
yybl	鬱鬱不樂
yybzp	燕樂半字譜
yyc	曳引車
yycc	一語成讖
yycc	陰陰沈沈
yycz	漁陽摻撾
yydd	妖妖調調
yydh	藝壓當行
yydl	音樂電鈴
yyeq	一躍而起
yyesbd	燕樂二十八調
yyfg	音樂風格
yyg	移液管
yygg	掖掖蓋蓋
yygg	聐聐聒聒
yygx	一意孤行
yyh	音樂會
yyh	音樂盒
yyhj	誘掖後進
yyhx	欲語還休
yyhy	以牙還牙
yyhy	以眼還眼
yyhy	醫藥行業
yyhz	夜月花朝
yyhz	月夜花朝
yyj	曳引機
yyj	液壓機
yyj	音樂劇
yyj	音樂家
yyj	音樂節
yyjj	郁郁青青
yyjxs	異菸鹼醯酸
yyk	音樂卡
yykg	餘勇可賈
yykt	躍躍狂徒
yyky	燕樂考源
yyl	樂毅論
yylc	淵遠流長
yylc	源遠流長
yylm	魚躍龍門
yylqt	銀樣蠟鎗頭
yymc	野有蔓草
yymm	猗猗靡靡
yyms	陰陽祕書
yynn	喁喁噥噥
yynn	燕語呢喃
yyp	音樂片
yypd	一語破的
yypz	一葉扁舟
yyq	葉一茜
yyqj	玉液瓊漿
yyqq	央央戧戧
yyqq	秧秧蹌蹌
yyr	音樂人
yysc	意義深長
yysf	一隅三反
yysj	野有死麕
yysj	音樂手機
yyss	意意似似
yyss	洋洋纚纚
yyst	營養失調
yysz	搖曳生姿
yyt	音樂廳
yyt	音樂臺
yytsg	音樂圖書館
yytt	泄泄沓沓
yywx	陰陽五行
yyxj	言揚行舉
yyxx	愉愉呴呴
yyxy	喁喁細語
yyxy	音樂學院
yyyf	魚躍鳶飛
yyys	躍躍欲試
yyyx	一言一行
yyz	熨衣枕
yyz	義妖傳
yyz	音樂站
yyz	鶯鶯傳
yyzd	一言中的
yyzd	一語中的
yyzd	一隅之地
yyzdq	一語撞倒牆
yyzj	一隅之見
yyzl	音樂治療
yyzs	遊營撞屍
yyzz	殷殷屯屯
yyzz	逸游自恣
yz	一扠
yz	一朝
yz	一着
yz	一轍
yz	倚重
yzbb	兗州八伯
yzbs	一着不慎
yzbsy	一朝被蛇咬
yzc	一着錯
yzc	養殖場
yzc	鴨跖草
yzcc	一展長才
yzcd	一爭長短
yzce	掩罪藏惡
yzcsz	一字長蛇陣
yzcz	銀質沉着
yzd	原子彈
yzd	菸紙店
yzdb	衣着打扮
yzes	義重恩深
yzfr	圜鑿方枘
yzg	鷹爪功
yzh	養殖戶
yzhg	嚴重後果
yzhs	油煠糊猻
yzj	一扎腳
yzj	因扎吉
yzj	圓周角
yzjx	一針見血
yzkfyh	亞洲開發銀行
yzl	圓周率
yzl	有着落
yzl	異重流
yzlb	羊撞籬笆
yzlqy	窨子裏秋月
yzlz	一走了之
yzm	眼扎毛
yzmsh	要怎麼收穫
yznf	以指撓沸
yznz	油紙捻子
yzq	一枝棲
yzqs	義重情深
yzqzs	一朝權在手
yzrs	義重如山
yzs	一磔手
yzsm	要做什麼
yzsy	益者三樂
yzt	圓仔湯
yzt	有賺頭
yztc	揚州彈詞
yztq	以珠彈雀
yzx	以字行
yzx	嚴重性
yzx	壓軸戲
yzxc	意志消沈
yzxc	語重心長
yzxx	夜住曉行
yzy	葉子菸
yzy	養殖業
yzyr	有朝一日
yzys	一張一弛
yzyx	一朝一夕
yzyx	嚴重影響
yzyy	養殖漁業
yzyz	用在一朝
yzz	嚴重者
yzz	壓軸子
yzzz	言之鑿鑿
z	ㄓ
z	ㄗ
z	㐱
z	㐺
z	㑁
za	藏獒
za	阻隘
zanx	窒礙難行
zb	主簿
zb	周髀
zb	坐簿
zb	宗伯
zb	屯剝
zbb	走百病
zbbm	朝不保暮
zbbx	朝不保夕
zbd	長不大
zbd	駐泊地
zbdf	中部地方
zbdq	中部地區
zbdq	周邊地區
zbe	着邊兒
zbfl	拽欛扶犁
zbgy	藏北高原
zbj	趙伯駒
zbjcrsg	豬八戒喫人參果
zbjl	準備金率
zbjx	朝不及夕
zbk	擇不開
zbl	做不了
zbl	朱柏廬
zbl	走不了
zbl	遮不了
zblx	朝不慮夕
zbmx	朝不謀夕
zbpm	拽布披麻
zbs	自白書
zbsh	知白守黑
zbsj	周髀算經
zbsy	正本溯源
zbsy	追本溯源
zbt	左伯桃
zbtd	這步田地
zbtx	朝不圖夕
zbxz	祖鞭先着
zbz	坐標軸
zbz	張柏芝
zbz	找不着
zbzbm	鐘不撞不鳴
zbzg	遲賓之館
zc	中朝
zc	主從
zc	之長
zc	佇眙
zc	傳乘
zcbd	折長補短
zcbl	支撐不了
zcbs	屬辭比事
zccg	資產重估
zccz	資產重組
zccz	造畜稠棧
zcd	最長的
zcfj	藏傳佛教
zcg	屬草稿
zcg	重倉股
zchd	指長話短
zcjd	爭長競短
zcjg	主從架構
zcjgzxwl	主從架構資訊網路
zcl	支持率
zcl	長出來
zcld	爭長論短
zcmb	震顫麻痺
zcml	朝參暮禮
zcml	珍藏密斂
zcms	朝趁暮食
zcmy	枝詞蔓語
zcq	中長期
zcq	轉轍器
zcql	咫尺千里
zcs	貯藏室
zcsh	咫尺山河
zcsjg	主從式架構
zcszlk	主從式資料庫
zct	仲長統
zctl	中長鐵路
zcty	咫尺天涯
zcwd	箸長碗短
zcwl	咫尺萬里
zcx	中長線
zcxg	朝出夕改
zcxzy	貯藏性資源
zcy	張朝陽
zcy	重脣音
zcym	珠沉玉沒
zcys	朝餐夜宿
zcyx	正常運行
zcyy	早賜玉音
zczd	咫尺之地
zczd	爭長爭短
zczx	政策執行
zczz	自僝自僽
zd	中地
zd	中彈
zd	中的
zd	中調
zd	中都
zdb	占地步
zdc	軸對稱
zdcf	重點採訪
zdcm	戰地春夢
zdcr	長大成人
zdd	着地點
zddq	中東地區
zddw	主導地位
zddx	專斷獨行
zddx	重點大學
zded	擇地而蹈
zdex	直道而行
zdf	子大夫
zdfwxw	正當防衛行爲
zdfz	坐地分贓
zdgc	重點工程
zdgl	最大功率
zdgs	重大過失
zdgz	重點工作
zdh	着大火
zdh	重點戶
zdhq	着地還錢
zdjc	重大決策
zdjs	重點建設
zdkz	鐘鼎款識
zdl	做得了
zdl	竹地雷
zdlbc	債多了不愁
zdlc	爭短論長
zdlhs	作倒了行市
zdly	重點領域
zdmj	佔地面積
zdmx	朝東暮西
zdp	占地盤
zdq	賺大錢
zdqc	紙短情長
zdql	自得其樂
zdqy	重點企業
zdr	曾道人
zds	這的是
zdsj	重大事件
zdsx	重大事項
zdt	擲彈筒
zdtp	重大突破
zdtx	戰地通訊
zdw	炙地臥
zdwm	指地爲盟
zdwt	重大問題
zdxm	重大項目
zdxm	重點項目
zdy	主調音
zdyc	晝短夜長
zdys	擲地有聲
zdyx	自動運行
zdyx	重大影響
zdyy	重大意義
zdz	撞釘子
zdzc	擲地之材
zdzjss	擲地作金石聲
zdzs	戰地鐘聲
zdzw	戰地政務
zdzx	重點中學
ze	憎惡
ze	着兒
ze	紮囮
ze	蕞爾
zed	扎耳朵
zem	屬耳目
zens	撾耳撓腮
zers	撾耳揉腮
zesz	罪惡深重
zezz	罪惡昭著
zf	劄付
zf	從法
zf	從父
zf	從犯
zf	從罰
zfbe	執法不阿
zfcz	撞府沖州
zfcz	撞府穿州
zfd	駐防地
zfft	着糞佛頭
zffy	章甫縫掖
zfh	中幡會
zfl	再犯率
zfny	追風躡影
zfw	撾婦翁
zfxz	朝發夕至
zfy	正番鴨
zfyc	正法眼藏
zfylbqt	丈夫有淚不輕彈
zfyz	擇福宜重
zfz	扎筏子
zfz	扎罰子
zfzj	轍鮒之急
zfzp	陟罰臧否
zg	噪聒
zg	圳溝
zg	坐賈
zg	從官
zg	忠告
zgd	諸宮調
zgdf	這個地方
zgdl	中國大陸
zgepd	準噶爾盆地
zgf	曾國藩
zgfy	跖狗吠堯
zghydbm	自古紅顏多薄命
zgj	軋鋼機
zgjmpjc	子宮頸抹片檢查
zgmg	朝更暮改
zgmpjc	子宮抹片檢查
zgmx	朝歌暮絃
zgmy	朝歌暮樂
zgnd	中國內地
zgq	曾國荃
zgsw	整躬率物
zgtb	周公吐哺
zgx	軸根系
zgxg	朝更夕改
zgxg	朝過夕改
zgxg	責躬省過
zgxs	張弓挾矢
zgxs	照功行賞
zgxs	走骨行屍
zgxx	職工學校
zgy	重工業
zgyh	中國銀行
zgyx	朝歌夜絃
zgz	長公主
zgzq	中國重汽
zgzy	至關重要
zh	中澣
zh	作諢
zh	咋呼
zh	在行
zh	屬和
zhbh	縱橫捭闔
zhcc	縱橫馳騁
zhcc	自毀長城
zhcs	墜歡重拾
zhd	着火點
zhd	震撼彈
zhdd	紫花地丁
zhh	藏紅花
zhhp	珠還合浦
zhjs	摭華捐實
zhks	拄笏看山
zhml	朝歡暮樂
zhnmzm	張黑女墓誌銘
zhql	追歡取樂
zhsw	重厚少文
zhtx	轍環天下
zhx	主和弦
zhxdx	智慧型大廈
zhxxcb	整合行銷傳播
zhy	縱壑魚
zhyc	種火又長
zhyh	綜合銀行
zhzq	陟岵陟屺
zhzw	陟岵瞻望
zj	中覺
zj	仔肩
zj	偵緝
zj	偵騎
zj	傳記
zjbh	只借不還
zjbq	趑趄不前
zjch	折戟沈河
zjcj	咫角驂駒
zjcljd	張家長李家短
zjcs	昭君出塞
zjd	偵緝隊
zjd	只覺得
zjd	宅基地
zjd	租借地
zjd	莊稼地
zjdd	中間地帶
zjdj	爪甲點金
zje	着勁兒
zjf	杖期夫
zjfd	洲際飛彈
zjff	摘奸發伏
zjfw	知覺防衛
zjg	直角規
zjgq	重機關槍
zjhf	昭君和番
zjjq	直節勁氣
zjjs	枕經藉史
zjjy	旨酒嘉肴
zjkt	珠璣咳唾
zjl	折價率
zjl	竹節蓼
zjld	直截了當
zjld	直捷了當
zjld	直接了當
zjms	朝經暮史
zjmy	朝虀暮鹽
zjn	貯精囊
zjps	屯蹶否塞
zjpy	占盡便宜
zjqg	趑趄卻顧
zjql	着急起來
zjqr	終軍棄繻
zjs	重晶石
zjs	重金屬
zjs	長見識
zjsb	嘴尖舌薄
zjshl	重金屬含量
zjsj	知覺神經
zjsjz	珠江三角洲
zjsl	着腳書樓
zjsz	中間宿主
zjts	專精覃思
zjwx	傳記文學
zjx	自覺性
zjxh	自覺形穢
zjxr	捉將挾人
zjxt	朝兢夕惕
zjxt	針芥相投
zjxt	鍼芥相投
zjxz	捉襟見肘
zjy	竹筴魚
zjyy	宗教音樂
zjyy	自給有餘
zjz	撞警鐘
zjz	曾紀澤
zjzb	直角坐標
zjze	長君之惡
zjzh	早借早還
zjzh	總角之好
zjzj	總角之交
zjzs	自覺遵守
zjzt	自嗟自嘆
zjzx	捉襟肘見
zjzx	踵決肘見
zjzz	自給自足
zk	屬纊
zk	屯坎
zk	扎括
zk	撞客
zk	斫鱠
zkb	宗喀巴
zkb	真空泵
zkd	嘴啃地
zknt	衆口難調
zkq	扎空槍
zkw	扎卡維
zkxx	專科學校
zkyx	自鄶以下
zl	之樂
zl	卓犖
zl	卓躒
zl	周率
zl	妯娌
zlb	重力壩
zlb	重力擺
zlbj	卓犖不羈
zlc	珠露茶
zlc	着陸場
zlcw	知來藏往
zld	嘴盧都
zld	着力點
zld	着陸點
zld	自留地
zld	轉捩點
zldj	張羅殆盡
zldl	椎輪大輅
zldt	專利地圖
zldz	中流砥柱
zlff	踔厲風發
zlfm	嶄露鋒芒
zlh	長老會
zlhj	字裏行間
zlhszblm	走了和尚走不了廟
zlj	重力計
zlj	重量級
zljh	長老教會
zljsd	重力加速度
zlmc	朝梁暮陳
zlmg	朝令暮改
zlmj	朝梁暮晉
zlmq	朝來暮去
zlpb	重利盤剝
zlqm	轍亂旗靡
zlqy	租賃契約
zls	重力水
zlsr	足了十人
zlss	枕流漱石
zltj	嶄露頭角
zltt	珠淚偷彈
zlwn	重力位能
zlxc	銖兩悉稱
zlxd	最流行的
zlxg	朝令夕改
zly	藏羚羊
zlyd	造陸運動
zlyt	朱陸異同
zlz	找樂子
zlz	摭溜子
zlz	柵剌子
zlz	趙令畤
zlzy	制禮作樂
zlzy	自憐自艾
zm	仔密
zm	仔麼
zm	咱們
zm	孳蔓
zm	宅門
zmas	曾母暗沙
zmby	子卯不樂
zmc	捉迷藏
zmcq	衆毛攢裘
zmd	殖民地
zmd	照明彈
zmdl	怎麼得了
zmdx	中美地峽
zmf	趙孟頫
zmgd	怎麼搞的
zmh	姊妹行
zmj	殖毛劑
zmj	芝麻秸
zmjy	殖民教育
zmjz	彰明較著
zmkk	衆目睽睽
zmks	朝暮課誦
zmll	屬毛離裏
zmlt	知命樂天
zmm	重眉毛
zmnt	滋蔓難圖
zmr	朝暮人
zms	中祕書
zms	作麼生
zms	斬馬謖
zmt	撞碼頭
zmtz	曾母投杼
zmx	姊妹校
zmy	撞門羊
zmy	着迷於
zmz	怎麼着
zmz	扎猛子
zmz	撞木鐘
zmz	這麼着
zmzc	殖民政策
zmzf	殖民政府
zmzy	扎眉扎眼
zmzy	殖民主義
zmzz	中懣之症
zn	周內
zn	嘴吶
zn	子埝
zn	屯難
zn	從女
znex	知難而行
zng	捉搦歌
znhh	乍暖還寒
znjj	鑽牛犄角
znjj	鑽牛角尖
znqn	重男輕女
znr	仔牛肉
znsz	罪孽深重
znsz	罪逆深重
znxy	知難行易
znzg	藏南縱谷
zp	做胚
zp	增聘
zp	屯否
zp	徵聘
zp	招聘
zpc	中胚層
zpfl	拽耙扶犁
zpm	縱剖面
zpq	長脾氣
zprw	臧否人物
zps	重炮手
zpwd	椎拍輐斷
zpy	佔便宜
zpy	占便宜
zpy	沾便宜
zpyd	最便宜的
zpydsd	占便宜的是獃
zpyh	昭披耶河
zq	中圻
zq	偵緝
zq	宅券
zq	張騫
zq	恣情
zqbb	朝氣勃勃
zqc	貯氣槽
zqd	偵緝隊
zqfy	跖犬吠堯
zqh	曾慶紅
zqjx	直情徑行
zqkl	中秋快樂
zql	中籤率
zql	準確率
zqll	真情流露
zqmc	朝秦暮楚
zqnl	招權納賂
zqpb	朝氣蓬勃
zqq	撞牆期
zqqs	重氣輕生
zqsz	知輕識重
zqxt	朝乾夕惕
zqyz	質妻鬻子
zqzy	恣情縱欲
zqzy	縱情恣欲
zr	剚刃
zr	崢嶸
zr	嶄然
zr	懾人
zr	撞擾
zrblx	真人不露相
zrbn	罪人不帑
zrd	自然堤
zrg	擇日館
zrg	豬肉乾
zrh	丈人行
zrl	自然率
zrll	自然利率
zrlw	乍入蘆圩
zrly	乍入蘆圩
zrml	朝榮暮落
zrn	重然諾
zrrj	昭然若揭
zrsy	崢嶸歲月
zrt	自然堤
zrwl	助人爲樂
zrxb	朝榮夕斃
zrxc	朝榮夕悴
zrxm	朝榮夕滅
zrxp	懾人心魄
zrxs	走肉行屍
zrxw	朝日新聞
zry	真溶液
zrz	擇日子
zrzjl	自然增加率
zs	中宿
zs	中樞
zs	乍熟
zs	住宿
zs	值宿
zsb	查士標
zsbl	真受不了
zsbx	至死不降
zsbzl	着三不着兩
zsc	鑿石穿
zscc	着手成春
zsd	主色調
zsdnfd	查士丁尼法典
zsdnys	查士丁尼一世
zsds	著述等身
zsdyz	蒸熟的鴨子
zsdyzfl	煮熟的鴨子飛了
zset	早熟兒童
zsex	擇善而行
zsez	澤深恩重
zsf	住宿費
zsf	着色法
zsf	重傷風
zsgh	周召共和
zsgh	轉死溝壑
zsgsgl	中山高速公路
zshc	着手回春
zsj	左上角
zsj	折射角
zsj	爭四角
zsj	珠三角
zsj	着手腳
zsjg	中樞機關
zsjx	正三角形
zsjyfx	衆生皆有佛性
zslbs	札什倫布寺
zsls	著書立說
zsly	着甚來由
zsm	做什麼
zsmg	朝升暮合
zsms	朝三暮四
zsms	朝四暮三
zsms	朝生暮死
zsmsh	嘴上抹石灰
zsmt	之死靡他
zsmt	之死靡它
zsmx	朝思暮想
zsqy	重色輕友
zss	枳首蛇
zssfyq	重水式反應器
zssj	中樞神經
zssl	枕石漱流
zssm	這是什麼
zssr	曾參殺人
zssx	正視繩行
zssx	正身率下
zssz	衆所熟知
zstj	紮實推進
zswd	置身無地
zswj	恣睢無忌
zswj	恣肆無忌
zswj	扎手舞腳
zswj	長孫無忌
zsx	朱士行
zsx	查慎行
zsx	長孫媳
zsxj	朝思夕計
zsxw	再生纖維
zsxx	朝思夕想
zsy	張僧繇
zsy	着手於
zsyh	招商銀行
zsyy	早賜玉音
zsz	左氏傳
zsz	照乘珠
zsz	終宿主
zsz	重傷罪
zsz	重身子
zszd	尊師重道
zszd	葬身之地
zszd	衆矢之的
zszw	着生植物
zszx	重賞之下
zt	傳踏
zt	噂沓
zt	宅土
zt	屬託
zt	庢沓
ztdd	戰天鬥地
ztdd	震天動地
ztgd	遮天蓋地
ztgx	震天價響
zth	撞天婚
zthd	指天畫地
zthd	震天駭地
ztkn	撞頭搕腦
ztl	旃荼羅
ztl	爪蹄類
ztmx	竹頭木屑
ztq	撞天屈
ztr	着疼熱
ztrd	鑽天入地
ztrzq	長他人志氣
zts	撞太歲
ztsd	指天說地
ztsx	自體輸血
ztx	重頭戲
ztxc	織田信長
ztz	擲骰子
ztzr	知疼着熱
zw	中浣
zw	咫聞
zw	屬文
zw	屬望
zw	崒兀
zwb	長尾巴
zwbz	做我不着
zwcz	債務重組
zwd	朝聞道
zwd	爪哇島
zwfx	自我反省
zwg	爪哇國
zwjj	主文譎諫
zwk	賺外快
zwkh	罪無可逭
zwlj	贓污狼藉
zwmj	轉彎抹角
zwmj	轉灣抹角
zwq	重武器
zwqw	重文輕武
zwr	爪哇人
zwsk	曾文水庫
zwsz	走爲上着
zwszs	植物生長素
zwx	曾文溪
zwxg	朝聞夕改
zwxs	朝聞夕死
zwxw	植物纖維
zwyq	濯污揚清
zwz	扎窩子
zwz	曾文正
zwz	爪哇族
zwz	鄭文焯
zx	中校
zx	之行
zx	仄行
zx	仔細
zx	再行
zxab	照相凹版
zxb	着先鞭
zxb	竈下婢
zxbj	朝夕不倦
zxc	自行車
zxcmq	自行車馬球
zxd	從兄弟
zxd	止血帶
zxd	止血點
zxdc	中心對稱
zxdl	齊心滌慮
zxds	執行董事
zxf	止血法
zxfs	字挾風霜
zxg	軸心國
zxgc	執行過程
zxhl	中心匯率
zxhy	知行合一
zxj	中心角
zxj	左下角
zxj	止血劑
zxjg	執行機關
zxjy	字學舉隅
zxjy	珍饈佳餚
zxk	仔細看
zxl	執行力
zxmd	朝西暮東
zxnb	朝夕難保
zxnp	招降納叛
zxns	招降納順
zxq	撞心拳
zxqk	執行情況
zxqx	椎心泣血
zxrc	宅心仁慈
zxrh	宅心仁厚
zxsy	恣心所欲
zxtn	誅兇殄逆
zxxc	朝夕相處
zxxg	朝行夕改
zxxx	直效行銷
zxyd	仔細閱讀
zxyh	中信銀行
zxyq	朱弦玉磬
zxyq	鑽隙踰牆
zxyy	莊舄越吟
zxz	執行者
zxz	戇小子
zxz	這行子
zxzbm	自見者不明
zxzh	宅心忠厚
zxzs	照相着色
zxzx	指瑕造隙
zxzy	知心着意
zy	傳驛
zy	吒異
zy	周顒
zy	周顗
zy	壯猷
zyb	作業簿
zybz	重要標誌
zybzh	撞一鼻子灰
zycdcz	自有長的撐住
zycl	濯纓滄浪
zyd	着眼點
zyd	租庸調
zydw	重要地位
zydz	中源地震
zyfa	朝陽方案
zyfz	重要分子
zyg	撾怨鼓
zyg	爪牙官
zygh	直言賈禍
zyh	子曰行
zyhyyh	做一行怨一行
zyj	注意將
zyj	着衣鏡
zyjc	重要舉措
zyje	作育菁莪
zyjgxx	中央警官學校
zyjh	重要講話
zyjx	晝夜兼行
zykt	中央空調
zyktxt	中央空調系統
zyl	佔有率
zyl	佔用率
zyl	爪牙吏
zymf	朝陽鳴鳳
zymy	朝雲暮雨
zynr	重要內容
zyprsdc	自有旁人說短長
zyq	曾蔭權
zyqc	重義輕財
zyqm	忠言奇謀
zyqs	重義輕生
zyqx	坐言起行
zyrw	重要任務
zyrz	致遠任重
zys	重元素
zysl	自由稅率
zysl	赭衣塞路
zysx	重要思想
zysz	罪業深重
zytg	濯纓彈冠
zythszytz	做一天和尚撞一天鐘
zytj	重要途徑
zyts	重於泰山
zywt	重要問題
zyww	恣意妄爲
zywx	恣意妄行
zywx	直言危行
zywz	張牙舞爪
zyx	張掖縣
zyx	自由行
zyx	重要性
zyxe	濯纓洗耳
zyxf	智圓行方
zyxn	知易行難
zyxs	朝饔夕飧
zyxx	職業學校
zyy	着眼於
zyye	屬垣有耳
zyyh	中央銀行
zyys	重要因素
zyyx	長幼有序
zyyy	噪音音樂
zyyy	重要原因
zyyy	重要意義
zyz	長一智
zyzc	左右支絀
zyzh	肘腋之患
zyzj	朱雲折檻
zyzj	爪牙之將
zyzl	知魚之樂
zyzl	自娛自樂
zyzp	招搖撞騙
zyzp	珠玉在傍
zyzs	爪牙之士
zyzy	肘腋之憂
zyzy	自怨自艾
zyzy	重要作用
zyzz	振衣濯足
zyzz	濯纓濯足
zyzz	自繇自在
zz	丁丁
zz	中藏
zz	主從
zz	主軸
zz	之重
zzbb	祭遵布被
zzbh	專恣跋扈
zzbj	諸子百家
zzbl	阻止不了
zzbm	輾轉不寐
zzbz	組織部長
zzcj	撞陣衝軍
zzcl	濯足滄浪
zzcl	知足常樂
zzcq	嘖嘖稱奇
zzcz	茁壯成長
zzd	中子彈
zzd	增長點
zzd	着重點
zzd	紙紮店
zzd	重重地
zzdf	主治大夫
zzdn	再長爹娘
zzdr	重責大任
zzds	自治都市
zzds	著作等身
zzdz	奓着膽子
zzet	扺掌而談
zzf	曾祖父
zzfc	輾轉反側
zzfc	轉輾反側
zzfd	增長幅度
zzfs	增長方式
zzg	駐劄國
zzgg	吱吱咯咯
zzgj	這種感覺
zzh	着重號
zzhs	朝朝寒食
zzjb	着着進逼
zzjg	主從架構
zzjgzxwl	主從架構資訊網路
zzjl	銖銖校量
zzjs	增長見識
zzjx	正在進行
zzjx	針針見血
zzkk	孜孜矻矻
zzl	增長率
zzl	著作郎
zzl	載重量
zzljq	著作鄰接權
zzlx	自助旅行
zzm	曾祖母
zzmb	震顫麻痺
zzmd	最終目的
zzmg	朝鐘暮鼓
zzmm	朝朝暮暮
zzmr	逐朝每日
zznj	追蹤躡跡
zzns	濯濯牛山
zzq	著作權
zzq	轉轍器
zzq	重災區
zzqf	著作權法
zzqk	杼軸其空
zzqs	鄭重其事
zzqwyh	著作權委員會
zzsb	着着失敗
zzsd	增長速度
zzsdehk	置之死地而後快
zzsdehs	置之死地而後生
zzsjg	主從式架構
zzsm	鄭重聲明
zzss	紮紮實實
zzsz	曾子殺彘
zzszlk	主從式資料庫
zzt	自傳體
zzts	撞鐘太歲
zzw	曾志偉
zzw	著作物
zzwh	譸張爲幻
zzwn	粥粥無能
zzws	尊重網上
zzww	顫顫巍巍
zzx	執着性
zzx	賊仔星
zzxc	輾轉相傳
zzxcf	輾轉相除法
zzxj	自墜陷阱
zzxt	組織協調
zzxz	自治行政
zzy	着重於
zzy	組織液
zzyc	左支右絀
zzyd	最重要的
zzyh	中資銀行
zzyj	鑿鑿有據
zzys	智者樂水
zzys	知者樂水
zzysbzr	只重衣衫不重人
zzyx	正在運行
zzyy	重質原油
zzz	組組長
zzzc	着重指出
zzzd	置足之地
zzzd	置錐之地
zzzj	自足自給
zzzs	矰繳之說
zzzs	迍邅之世
zzzy	著作自由
zzzz	吱吱喳喳
zzzz	重中之重
